id,deep,deep_allowed,deepNet,result,ppda_cal,allowed_ppda,ppdaNet,HS.x,HST.x,HF.x,HC.x,HY.x,HR.x,AS.x,AST.x,AF.x,AC.x,AY.x,AR.x,ShotNet,STNet,FNet,CNet,YNet,RNet,HtrgPerc,AtrgPerc,PercNet
1,11,5,6,w,5.942857143,21.45454545,-15.51168831,15,7,9,11,0,0,12,5,9,2,2,0,3,2,0,9,-2,0,0.466666667,0.416666667,0.05
2,5,11,-6,l,21.45454545,5.942857143,15.51168831,15,7,9,11,0,0,12,5,9,2,2,0,3,2,0,9,-2,0,0.466666667,0.416666667,0.05
3,9,1,8,w,6.935483871,16.4,-9.464516129,5,3,6,1,2,0,14,9,13,1,2,0,-9,-6,-7,0,0,0,0.6,0.642857143,-0.042857143
4,1,9,-8,l,16.4,6.935483871,9.464516129,5,3,6,1,2,0,14,9,13,1,2,0,-9,-6,-7,0,0,0,0.6,0.642857143,-0.042857143
5,4,6,-2,d,13.6,9.133333333,4.466666667,13,3,10,3,2,0,8,3,19,4,1,0,5,0,-9,-1,1,0,0.230769231,0.375,-0.144230769
6,5,7,-2,w,11.5,9.785714286,1.714285714,11,3,15,5,0,0,5,3,11,2,1,0,6,0,4,3,-1,0,0.272727273,0.6,-0.327272727
7,0,9,-9,w,9.277777778,5.5,3.777777778,10,4,6,2,0,0,11,3,12,7,0,0,-1,1,-6,-5,0,0,0.4,0.272727273,0.127272727
8,5,5,0,d,11.30769231,4.074074074,7.233618236,6,2,16,6,2,0,10,3,14,2,1,1,-4,-1,2,4,1,-1,0.333333333,0.3,0.033333333
9,5,5,0,d,4.074074074,11.30769231,-7.233618236,6,2,16,6,2,0,10,3,14,2,1,1,-4,-1,2,4,1,-1,0.333333333,0.3,0.033333333
10,6,4,2,d,9.133333333,13.6,-4.466666667,13,3,10,3,2,0,8,3,19,4,1,0,5,0,-9,-1,1,0,0.230769231,0.375,-0.144230769
11,9,0,9,l,5.5,9.277777778,-3.777777778,10,4,6,2,0,0,11,3,12,7,0,0,-1,1,-6,-5,0,0,0.4,0.272727273,0.127272727
12,7,5,2,l,9.785714286,11.5,-1.714285714,11,3,15,5,0,0,5,3,11,2,1,0,6,0,4,3,-1,0,0.272727273,0.6,-0.327272727
13,2,15,-13,l,13.42105263,5.25,8.17105263,31,7,13,14,1,0,7,4,9,0,0,0,24,3,4,14,1,0,0.225806452,0.571428571,-0.345622119
14,15,2,13,w,5.25,13.42105263,-8.17105263,31,7,13,14,1,0,7,4,9,0,0,0,24,3,4,14,1,0,0.225806452,0.571428571,-0.345622119
15,10,1,9,w,11.05263158,13.20689655,-2.15426497,9,2,12,5,1,0,8,2,7,3,3,0,1,0,5,2,-2,0,0.222222222,0.25,-0.027777778
16,7,3,4,d,6.434782609,18.66666667,-12.23188406,15,1,3,12,0,0,8,2,13,3,2,0,7,-1,-10,9,-2,0,0.066666667,0.25,-0.183333333
17,1,10,-9,l,13.20689655,11.05263158,2.15426497,9,2,12,5,1,0,8,2,7,3,3,0,1,0,5,2,-2,0,0.222222222,0.25,-0.027777778
18,3,7,-4,d,18.66666667,6.434782609,12.23188406,15,1,3,12,0,0,8,2,13,3,2,0,7,-1,-10,9,-2,0,0.066666667,0.25,-0.183333333
19,4,8,-4,l,6.452380952,9.064516129,-2.612135177,11,5,15,3,3,0,18,7,13,5,4,0,-7,-2,2,-2,-1,0,0.454545455,0.388888889,0.065656566
20,8,4,4,w,9.064516129,6.452380952,2.612135177,11,5,15,3,3,0,18,7,13,5,4,0,-7,-2,2,-2,-1,0,0.454545455,0.388888889,0.065656566
21,8,4,4,w,5.3125,11.38461538,-6.07211538,16,9,13,10,2,0,18,5,11,7,1,0,-2,4,2,3,1,0,0.5625,0.277777778,0.284722222
22,4,8,-4,l,11.38461538,5.3125,6.07211538,16,9,13,10,2,0,18,5,11,7,1,0,-2,4,2,3,1,0,0.5625,0.277777778,0.284722222
23,12,9,3,l,13,10.72,2.28,22,7,10,10,0,0,12,4,13,5,2,0,10,3,-3,5,-2,0,0.318181818,0.333333333,-0.015151515
24,9,12,-3,w,10.72,13,-2.28,22,7,10,10,0,0,12,4,13,5,2,0,10,3,-3,5,-2,0,0.318181818,0.333333333,-0.015151515
25,8,4,4,d,5.485714286,8.870967742,-3.385253456,16,4,11,8,0,0,8,3,10,6,2,0,8,1,1,2,-2,0,0.25,0.375,-0.125
26,4,3,1,w,8.863636364,3.925,4.938636364,12,2,11,4,2,0,8,2,11,7,3,0,4,0,0,-3,-1,0,0.166666667,0.25,-0.083333333
27,6,1,5,w,9.428571429,12,-2.571428571,14,3,10,5,2,0,15,6,6,9,1,0,-1,-3,4,-4,1,0,0.214285714,0.4,-0.185714286
28,6,9,-3,l,17.5,13.92857143,3.57142857,15,8,9,7,1,0,10,3,11,5,3,0,5,5,-2,2,-2,0,0.533333333,0.3,0.233333333
29,9,6,3,w,13.92857143,17.5,-3.57142857,15,8,9,7,1,0,10,3,11,5,3,0,5,5,-2,2,-2,0,0.533333333,0.3,0.233333333
30,1,6,-5,l,12,9.428571429,2.571428571,14,3,10,5,2,0,15,6,6,9,1,0,-1,-3,4,-4,1,0,0.214285714,0.4,-0.185714286
31,3,4,-1,l,3.925,8.863636364,-4.938636364,12,2,11,4,2,0,8,2,11,7,3,0,4,0,0,-3,-1,0,0.166666667,0.25,-0.083333333
32,4,8,-4,d,8.870967742,5.485714286,3.385253456,16,4,11,8,0,0,8,3,10,6,2,0,8,1,1,2,-2,0,0.25,0.375,-0.125
33,10,2,8,d,8.976744186,47.14285714,-38.16611295,30,10,14,13,1,0,3,2,4,2,0,0,27,8,10,11,1,0,0.333333333,0.666666667,-0.333333334
34,2,10,-8,d,47.14285714,8.976744186,38.16611295,30,10,14,13,1,0,3,2,4,2,0,0,27,8,10,11,1,0,0.333333333,0.666666667,-0.333333334
35,5,2,3,l,11.6,11.12,0.48,15,3,16,8,3,0,6,4,11,4,1,0,9,-1,5,4,2,0,0.2,0.666666667,-0.466666667
36,2,5,-3,w,11.12,11.6,-0.48,15,3,16,8,3,0,6,4,11,4,1,0,9,-1,5,4,2,0,0.2,0.666666667,-0.466666667
37,4,5,-1,d,10.57692308,6.297297297,4.279625783,14,5,9,4,1,0,12,3,14,5,0,0,2,2,-5,-1,1,0,0.357142857,0.25,0.107142857
38,5,4,1,d,6.297297297,10.57692308,-4.279625783,14,5,9,4,1,0,12,3,14,5,0,0,2,2,-5,-1,1,0,0.357142857,0.25,0.107142857
39,9,5,4,d,8.363636364,19.95,-11.58636364,6,2,17,4,2,0,9,2,8,6,2,0,-3,0,9,-2,0,0,0.333333333,0.222222222,0.111111111
40,5,9,-4,d,19.95,8.363636364,11.58636364,6,2,17,4,2,0,9,2,8,6,2,0,-3,0,9,-2,0,0,0.333333333,0.222222222,0.111111111
41,6,12,-6,w,13.25,5.407407407,7.842592593,7,3,10,0,2,0,12,1,18,6,3,0,-5,2,-8,-6,-1,0,0.428571429,0.083333333,0.345238096
42,12,6,6,l,5.407407407,13.25,-7.842592593,7,3,10,0,2,0,12,1,18,6,3,0,-5,2,-8,-6,-1,0,0.428571429,0.083333333,0.345238096
43,12,5,7,w,13.72727273,10,3.72727273,6,5,9,1,1,0,23,8,9,8,1,0,-17,-3,0,-7,0,0,0.833333333,0.347826087,0.485507246
44,5,12,-7,l,10,13.72727273,-3.72727273,6,5,9,1,1,0,23,8,9,8,1,0,-17,-3,0,-7,0,0,0.833333333,0.347826087,0.485507246
45,6,6,0,l,9.173913043,10.75,-1.576086957,12,3,9,8,1,1,12,4,10,5,3,0,0,-1,-1,3,-2,1,0.25,0.333333333,-0.083333333
46,2,7,-5,w,15.27777778,6.857142857,8.420634923,22,3,8,8,2,0,5,3,18,1,4,0,17,0,-10,7,-2,0,0.136363636,0.6,-0.463636364
47,9,4,5,w,8.941176471,11.39130435,-2.450127879,8,3,11,7,1,0,10,2,6,4,0,0,-2,1,5,3,1,0,0.375,0.2,0.175
48,7,2,5,l,6.857142857,15.27777778,-8.420634923,22,3,8,8,2,0,5,3,18,1,4,0,17,0,-10,7,-2,0,0.136363636,0.6,-0.463636364
49,4,9,-5,l,11.39130435,8.941176471,2.450127879,8,3,11,7,1,0,10,2,6,4,0,0,-2,1,5,3,1,0,0.375,0.2,0.175
50,6,6,0,w,10.75,9.173913043,1.576086957,12,3,9,8,1,1,12,4,10,5,3,0,0,-1,-1,3,-2,1,0.25,0.333333333,-0.083333333
51,20,10,10,l,9.285714286,12.94736842,-3.661654134,23,3,12,8,1,0,16,10,11,7,1,0,7,-7,1,1,0,0,0.130434783,0.625,-0.494565217
52,10,20,-10,w,12.94736842,9.285714286,3.661654134,23,3,12,8,1,0,16,10,11,7,1,0,7,-7,1,1,0,0,0.130434783,0.625,-0.494565217
53,7,9,-2,l,28.42857143,9.783783784,18.64478765,25,5,8,6,1,0,9,3,5,4,1,0,16,2,3,2,0,0,0.2,0.333333333,-0.133333333
54,9,7,2,w,9.783783784,28.42857143,-18.64478765,25,5,8,6,1,0,9,3,5,4,1,0,16,2,3,2,0,0,0.2,0.333333333,-0.133333333
55,3,17,-14,l,22.9,5.173913043,17.72608696,10,7,7,4,1,0,19,5,13,5,3,0,-9,2,-6,-1,-2,0,0.7,0.263157895,0.436842105
56,17,3,14,w,5.173913043,22.9,-17.72608696,10,7,7,4,1,0,19,5,13,5,3,0,-9,2,-6,-1,-2,0,0.7,0.263157895,0.436842105
57,4,4,0,d,14.61904762,11.83333333,2.78571429,17,2,9,4,0,0,13,4,11,3,2,0,4,-2,-2,1,-2,0,0.117647059,0.307692308,-0.190045249
58,5,8,-3,w,32.3,4.842105263,27.45789474,17,2,10,6,2,0,8,3,5,6,2,0,9,-1,5,0,0,0,0.117647059,0.375,-0.257352941
59,8,5,3,l,4.842105263,32.3,-27.45789474,17,2,10,6,2,0,8,3,5,6,2,0,9,-1,5,0,0,0,0.117647059,0.375,-0.257352941
60,4,4,0,d,11.83333333,14.61904762,-2.78571429,17,2,9,4,0,0,13,4,11,3,2,0,4,-2,-2,1,-2,0,0.117647059,0.307692308,-0.190045249
61,13,6,7,d,13.57142857,6.666666667,6.904761903,10,2,17,2,1,1,21,8,7,3,2,0,-11,-6,10,-1,-1,1,0.2,0.380952381,-0.180952381
62,6,13,-7,d,6.666666667,13.57142857,-6.904761903,10,2,17,2,1,1,21,8,7,3,2,0,-11,-6,10,-1,-1,1,0.2,0.380952381,-0.180952381
63,5,13,-8,l,9.04,9,0.04,22,5,15,13,2,0,10,2,16,2,4,1,12,3,-1,11,-2,-1,0.227272727,0.2,0.027272727
64,7,10,-3,l,10,6.914285714,3.085714286,13,5,9,4,1,0,8,2,11,5,3,0,5,3,-2,-1,-2,0,0.384615385,0.25,0.134615385
65,7,16,-9,l,21.625,11.4375,10.1875,15,6,10,8,1,0,6,2,6,1,1,0,9,4,4,7,0,0,0.4,0.333333333,0.066666667
66,4,5,-1,d,14.88235294,20.91666667,-6.03431373,13,5,6,3,0,0,8,2,11,4,1,0,5,3,-5,-1,-1,0,0.384615385,0.25,0.134615385
67,13,5,8,w,9,9.04,-0.04,22,5,15,13,2,0,10,2,16,2,4,1,12,3,-1,11,-2,-1,0.227272727,0.2,0.027272727
68,10,7,3,w,6.914285714,10,-3.085714286,13,5,9,4,1,0,8,2,11,5,3,0,5,3,-2,-1,-2,0,0.384615385,0.25,0.134615385
69,16,7,9,w,11.4375,21.625,-10.1875,15,6,10,8,1,0,6,2,6,1,1,0,9,4,4,7,0,0,0.4,0.333333333,0.066666667
70,2,6,-4,d,19.6,12,7.6,13,5,5,6,2,0,13,3,11,5,3,0,0,2,-6,1,-1,0,0.384615385,0.230769231,0.153846154
71,5,12,-7,l,8.740740741,7.842105263,0.898635478,18,8,16,8,2,0,8,3,10,2,1,0,10,5,6,6,1,0,0.444444444,0.375,0.069444444
72,5,4,1,d,20.91666667,14.88235294,6.03431373,13,5,6,3,0,0,8,2,11,4,1,0,5,3,-5,-1,-1,0,0.384615385,0.25,0.134615385
73,6,2,4,d,12,19.6,-7.6,13,5,5,6,2,0,13,3,11,5,3,0,0,2,-6,1,-1,0,0.384615385,0.230769231,0.153846154
74,12,5,7,w,7.842105263,8.740740741,-0.898635478,18,8,16,8,2,0,8,3,10,2,1,0,10,5,6,6,1,0,0.444444444,0.375,0.069444444
75,0,11,-11,l,16.26315789,6.208333333,10.05482456,7,2,10,6,0,0,15,7,16,4,0,0,-8,-5,-6,2,0,0,0.285714286,0.466666667,-0.180952381
76,11,0,11,w,6.208333333,16.26315789,-10.05482456,7,2,10,6,0,0,15,7,16,4,0,0,-8,-5,-6,2,0,0,0.285714286,0.466666667,-0.180952381
77,4,5,-1,w,5.333333333,20.16666667,-14.83333334,15,6,12,7,1,0,8,5,12,7,4,1,7,1,0,0,-3,-1,0.4,0.625,-0.225
78,5,4,1,l,20.16666667,5.333333333,14.83333334,15,6,12,7,1,0,8,5,12,7,4,1,7,1,0,0,-3,-1,0.4,0.625,-0.225
79,12,6,6,d,6.787878788,12.17647059,-5.388591802,26,8,13,11,3,0,13,9,19,6,5,0,13,-1,-6,5,-2,0,0.307692308,0.692307692,-0.384615384
80,6,12,-6,d,12.17647059,6.787878788,5.388591802,26,8,13,11,3,0,13,9,19,6,5,0,13,-1,-6,5,-2,0,0.307692308,0.692307692,-0.384615384
81,19,4,15,w,6.958333333,41.9,-34.94166667,21,9,5,10,0,0,8,1,4,1,0,0,13,8,1,9,0,0,0.428571429,0.125,0.303571429
82,4,19,-15,l,41.9,6.958333333,34.94166667,21,9,5,10,0,0,8,1,4,1,0,0,13,8,1,9,0,0,0.428571429,0.125,0.303571429
83,13,4,9,d,3.964285714,12.1,-8.135714286,14,5,13,3,0,0,7,1,7,6,2,0,7,4,6,-3,-2,0,0.357142857,0.142857143,0.214285714
84,4,13,-9,d,12.1,3.964285714,8.135714286,14,5,13,3,0,0,7,1,7,6,2,0,7,4,6,-3,-2,0,0.357142857,0.142857143,0.214285714
85,6,5,1,w,7.1,13.10714286,-6.00714286,11,4,8,7,1,0,15,6,11,5,2,0,-4,-2,-3,2,-1,0,0.363636364,0.4,-0.036363636
86,5,8,-3,l,17.08333333,6.545454545,10.53787879,13,5,19,4,4,0,11,6,11,3,2,0,2,-1,8,1,2,0,0.384615385,0.545454545,-0.16083916
87,4,4,0,l,4.771428571,9.72,-4.948571429,10,5,14,3,1,0,9,3,14,9,2,0,1,2,0,-6,-1,0,0.5,0.333333333,0.166666667
88,4,4,0,w,9.72,4.771428571,4.948571429,10,5,14,3,1,0,9,3,14,9,2,0,1,2,0,-6,-1,0,0.5,0.333333333,0.166666667
89,8,7,1,l,12.52380952,12.82352941,-0.29971989,17,4,10,12,1,1,11,7,7,6,1,0,6,-3,3,6,0,1,0.235294118,0.636363636,-0.401069518
90,7,8,-1,w,12.82352941,12.52380952,0.29971989,17,4,10,12,1,1,11,7,7,6,1,0,6,-3,3,6,0,1,0.235294118,0.636363636,-0.401069518
91,8,5,3,w,6.545454545,17.08333333,-10.53787879,13,5,19,4,4,0,11,6,11,3,2,0,2,-1,8,1,2,0,0.384615385,0.545454545,-0.16083916
92,5,6,-1,l,13.10714286,7.1,6.00714286,11,4,8,7,1,0,15,6,11,5,2,0,-4,-2,-3,2,-1,0,0.363636364,0.4,-0.036363636
93,14,6,8,l,7.958333333,18.42857143,-10.4702381,7,3,8,3,3,0,25,8,7,16,1,0,-18,-5,1,-13,2,0,0.428571429,0.32,0.108571429
94,6,14,-8,w,18.42857143,7.958333333,10.4702381,7,3,8,3,3,0,25,8,7,16,1,0,-18,-5,1,-13,2,0,0.428571429,0.32,0.108571429
95,3,9,-6,w,12.09090909,5.516129032,6.574780058,13,6,5,7,0,0,14,5,14,7,4,0,-1,1,-9,0,-4,0,0.461538462,0.357142857,0.104395605
96,9,3,6,l,5.516129032,12.09090909,-6.574780058,13,6,5,7,0,0,14,5,14,7,4,0,-1,1,-9,0,-4,0,0.461538462,0.357142857,0.104395605
97,7,12,-5,d,21.41666667,9.071428571,12.3452381,31,7,14,7,3,0,10,4,4,1,3,0,21,3,10,6,0,0,0.225806452,0.4,-0.174193548
98,12,7,5,d,9.071428571,21.41666667,-12.3452381,31,7,14,7,3,0,10,4,4,1,3,0,21,3,10,6,0,0,0.225806452,0.4,-0.174193548
99,4,9,-5,d,9.681818182,10.09090909,-0.409090908,10,5,13,2,2,0,13,1,12,4,1,1,-3,4,1,-2,1,-1,0.5,0.076923077,0.423076923
100,9,4,5,d,10.09090909,9.681818182,0.409090908,10,5,13,2,2,0,13,1,12,4,1,1,-3,4,1,-2,1,-1,0.5,0.076923077,0.423076923
101,2,6,-4,w,17.9375,4.085714286,13.85178571,25,6,8,4,1,0,6,3,9,5,3,0,19,3,-1,-1,-2,0,0.24,0.5,-0.26
102,6,2,4,l,4.085714286,17.9375,-13.85178571,25,6,8,4,1,0,6,3,9,5,3,0,19,3,-1,-1,-2,0,0.24,0.5,-0.26
103,7,9,-2,w,10.63636364,5.617647059,5.018716581,16,7,16,8,1,0,11,4,13,2,2,0,5,3,3,6,-1,0,0.4375,0.363636364,0.073863636
104,9,7,2,l,5.617647059,10.63636364,-5.018716581,16,7,16,8,1,0,11,4,13,2,2,0,5,3,3,6,-1,0,0.4375,0.363636364,0.073863636
105,7,9,-2,w,11.68,14.9,-3.22,13,6,11,7,0,0,11,2,10,3,1,0,2,4,1,4,-1,0,0.461538462,0.181818182,0.27972028
106,9,2,7,l,5.647058824,13.15,-7.502941176,16,3,9,12,1,0,2,1,9,3,3,0,14,2,0,9,-2,0,0.1875,0.5,-0.3125
107,13,1,12,w,11.33333333,35.83333333,-24.5,28,11,5,5,2,0,5,4,9,4,2,0,23,7,-4,1,0,0,0.392857143,0.8,-0.407142857
108,9,7,2,l,14.9,11.68,3.22,13,6,11,7,0,0,11,2,10,3,1,0,2,4,1,4,-1,0,0.461538462,0.181818182,0.27972028
109,2,9,-7,w,13.15,5.647058824,7.502941176,16,3,9,12,1,0,2,1,9,3,3,0,14,2,0,9,-2,0,0.1875,0.5,-0.3125
110,1,13,-12,l,35.83333333,11.33333333,24.5,28,11,5.00E+00,5,2,0,5,4,9,4,2,0,23,7,-4,1,0,0,0.392857143,0.8,-0.407142857
111,6,4,2,d,6.095238095,22.9,-16.80476191,11,4,12,5,2,0,16,3,8,3,1,0,-5,1,4,2,1,0,0.363636364,0.1875,0.176136364
112,4,6,-2,d,22.9,6.095238095,16.80476191,11,4,12,5,2,0,16,3,8,3,1,0,-5,1,4,2,1,0,0.363636364,0.1875,0.176136364
113,6,5,1,d,13.94736842,12.52380952,1.4235589,13,4,7,6,2,0,14,4,10,7,1,1,-1,0,-3,-1,1,-1,0.307692308,0.285714286,0.021978022
114,5,4,1,l,17.18181818,14.94736842,2.23444976,8,6,8,3,2,0,9,3,9,7,2,0,-1,3,-1,-4,0,0,0.75,0.333333333,0.416666667
115,4,5,-1,w,14.94736842,17.18181818,-2.23444976,8,6,8,3,2,0,9,3,9,7,2,0,-1,3,-1,-4,0,0,0.75,0.333333333,0.416666667
116,5,6,-1,d,12.52380952,13.94736842,-1.4235589,13,4,7,6,2,0,14,4,10,7,1,1,-1,0,-3,-1,1,-1,0.307692308,0.285714286,0.021978022
117,12,8,4,w,9.1,11,-1.9,21,6,13,9,5,1,14,9,15,4,1,0,7,-3,-2,5,4,1,0.285714286,0.642857143,-0.357142857
118,8,12,-4,l,11,9.1,1.9,21,6,13,9,5,1,14,9,15,4,1,0,7,-3,-2,5,4,1,0.285714286,0.642857143,-0.357142857
119,5,5,0,l,11.625,7.914285714,3.710714286,13,2,8,6,3,0,6,3,13,4,3,0,7,-1,-5,2,0,0,0.153846154,0.5,-0.346153846
120,5,5,0,w,7.914285714,11.625,-3.710714286,13,2,8,6,3,0,6,3,13,4,3,0,7,-1,-5,2,0,0,0.153846154,0.5,-0.346153846
121,11,1,10,w,11.27272727,24.23529412,-12.96256685,12,2,8,6,1,0,16,4,4,5,1,0,-4,-2,4,1,0,0,0.166666667,0.25,-0.083333333
122,1,11,-10,l,24.23529412,11.27272727,12.96256685,12,2,8,6,1,0,16,4,4,5,1,0,-4,-2,4,1,0,0,0.166666667,0.25,-0.083333333
123,3,2,1,d,6.05,9.045454545,-2.995454545,16,3,10,7,1,0,10,3,16,3,4,0,6,0,-6,4,-3,0,0.1875,0.3,-0.1125
124,8,17,-9,d,11.25,13.1,-1.85,13,5,7,6,3,0,17,6,8,6,1,0,-4,-1,-1,0,2,0,0.384615385,0.352941176,0.031674209
125,0,9,-9,l,12.76923077,14.54166667,-1.7724359,24,10,5,5,2,0,8,1,13,2,3,0,16,9,-8,3,-1,0,0.416666667,0.125,0.291666667
126,2,3,-1,d,9.045454545,6.05,2.995454545,16,3,10,7,1,0,10,3,16,3,4,0,6,0,-6,4,-3,0,0.1875,0.3,-0.1125
127,9,0,9,w,14.54166667,12.76923077,1.7724359,24,10,5,5,2,0,8,1,13,2,3,0,16,9,-8,3,-1,0,0.416666667,0.125,0.291666667
128,11,10,1,w,12.7826087,9.111111111,3.671497589,15,3,14,5,3,0,10,3,10,5,1,0,5,0,4,0,2,0,0.2,0.3,-0.1
129,10,11,-1,l,9.111111111,12.7826087,-3.671497589,15,3,14,5,3,0,10,3,10,5,1,0,5,0,4,0,2,0,0.2,0.3,-0.1
130,8,7,1,l,5.648648649,31.75,-26.10135135,9,4,5,6,0,1,14,6,16,6,2,0,-5,-2,-11,0,-2,1,0.444444444,0.428571429,0.015873015
131,7,8,-1,w,31.75,5.648648649,26.10135135,9,4,5,6,0,1,14,6,16,6,2,0,-5,-2,-11,0,-2,1,0.444444444,0.428571429,0.015873015
132,10,5,5,l,11.38095238,22.9375,-11.55654762,6,2,5,1,0,0,14,5,6,6,1,0,-8,-3,-1,-5,-1,0,0.333333333,0.357142857,-0.023809524
133,17,8,9,d,13.1,11.25,1.85,13,5,7,6,3,0,17,6,8,6,1,0,-4,-1,-1,0,2,0,0.384615385,0.352941176,0.031674209
134,5,10,-5,w,22.9375,11.38095238,11.55654762,6,2,5,1,0,0,14,5,6,6,1,0,-8,-3,-1,-5,-1,0,0.333333333,0.357142857,-0.023809524
135,6,13,-7,l,32.66666667,9.714285714,22.95238096,12,8,4,5,2,0,20,9,8,2,2,0,-8,-1,-4,3,0,0,0.666666667,0.45,0.216666667
136,13,6,7,w,9.714285714,32.66666667,-22.95238096,12,8,4,5,2,0,20,9,8,2,2,0,-8,-1,-4,3,0,0,0.666666667,0.45,0.216666667
137,13,1,12,w,5.558823529,35.72727273,-30.1684492,13,5,12,9,1,0,3,0,9,0,1,1,10,5,3,9,0,-1,0.384615385,0,0.384615385
138,1,13,-12,l,35.72727273,5.558823529,30.1684492,13,5,12,9,1,0,3,0,9,0,1,1,10,5,3,9,0,-1,0.384615385,0,0.384615385
139,7,5,2,d,10.125,5.925925926,4.199074074,16,4,18,8,4,0,10,5,13,7,2,0,6,-1,5,1,2,0,0.25,0.5,-0.25
140,5,7,-2,d,5.925925926,10.125,-4.199074074,16,4,18,8,4,0,10,5,13,7,2,0,6,-1,5,1,2,0,0.25,0.5,-0.25
141,12,4,8,w,8.135135135,15.23529412,-7.100158985,17,6,11,4,2,0,8,3,7,4,1,0,9,3,4,0,1,0,0.352941176,0.375,-0.022058824
142,4,12,-8,l,15.23529412,8.135135135,7.100158985,17,6,11,4,2,0,8,3,7,4,1,0,9,3,4,0,1,0,0.352941176,0.375,-0.022058824
143,9,13,-4,w,8.8,6.041666667,2.758333333,21,5,14,10,1,0,22,12,17,6,3,0,-1,-7,-3,4,-2,0,0.238095238,0.545454545,-0.307359307
144,6,4,2,w,19.5,7.8,11.7,9,3,5,7,2,0,11,2,12,9,1,1,-2,1,-7,-2,1,-1,0.333333333,0.181818182,0.151515151
145,4,6,-2,l,7.8,19.5,-11.7,9,3,5,7,2,0,11,2,12,9,1,1,-2,1,-7,-2,1,-1,0.333333333,0.181818182,0.151515151
146,4,12,-8,l,9.25,7.78125,1.46875,18,8,9,4,1,0,2,1,17,6,4,0,16,7,-8,-2,-3,0,0.444444444,0.5,-0.055555556
147,12,4,8,w,7.78125,9.25,-1.46875,18,8,9,4,1,0,2,1,17,6,4,0,16,7,-8,-2,-3,0,0.444444444,0.5,-0.055555556
148,13,9,4,l,6.041666667,8.8,-2.758333333,21,5,14,10,1,0,22,12,17,6,3,0,-1,-7,-3,4,-2,0,0.238095238,0.545454545,-0.307359307
149,5,2,3,d,6.727272727,19.375,-12.64772727,8,2,7,7,0,0,9,3,6,7,2,0,-1,-1,1,0,-2,0,0.25,0.333333333,-0.083333333
150,2,5,-3,d,19.375,6.727272727,12.64772727,8,2,7,7,0,0,9,3,6,7,2,0,-1,-1,1,0,-2,0,0.25,0.333333333,-0.083333333
151,7,7,0,w,20.07142857,14.78947368,5.28195489,9,4,11,2,3,0,7,4,7,2,2,0,2,0,4,0,1,0,0.444444444,0.571428571,-0.126984127
152,7,7,0,l,14.78947368,20.07142857,-5.28195489,9,4,11,2,3,0,7,4,7,2,2,0,2,0,4,0,1,0,0.444444444,0.571428571,-0.126984127
153,10,7,3,w,7.028571429,10.2173913,-3.188819871,12,2,12,14,1,0,10,2,6,5,2,0,2,0,6,9,-1,0,0.166666667,0.2,-0.033333333
154,7,10,-3,l,10.2173913,7.028571429,3.188819871,12,2,12,14,1,0,10,2,6,5,2,0,2,0,6,9,-1,0,0.166666667,0.2,-0.033333333
155,10,5,5,w,11.10526316,10.88461538,0.22064778,10,3,8,3,0,0,13,7,15,4,1,0,-3,-4,-7,-1,-1,0,0.3,0.538461538,-0.238461538
156,13,1,12,l,4.115384615,19.6875,-15.57211539,18,2,11,9,5,0,7,2,14,1,2,0,11,0,-3,8,3,0,0.111111111,0.285714286,-0.174603175
157,5,10,-5,l,10.88461538,11.10526316,-0.22064778,10,3,8,3,0,0,13,7,15,4,1,0,-3,-4,-7,-1,-1,0,0.3,0.538461538,-0.238461538
158,1,13,-12,w,19.6875,4.115384615,15.57211539,18,2,11,9,5,0,7,2,14,1,2,0,11,0,-3,8,3,0,0.111111111,0.285714286,-0.174603175
159,5,1,4,l,6.818181818,28.45454545,-21.63636363,12,2,12,4,3,0,12,3,10,6,3,0,0,-1,2,-2,0,0,0.166666667,0.25,-0.083333333
160,1,5,-4,w,28.45454545,6.818181818,21.63636363,12,2,12,4,3,0,12,3,10,6,3,0,0,-1,2,-2,0,0,0.166666667,0.25,-0.083333333
161,11,3,8,w,5.71875,10.05263158,-4.33388158,19,10,15,11,2,0,8,4,15,2,2,0,11,6,0,9,0,0,0.526315789,0.5,0.026315789
162,3,11,-8,l,10.05263158,5.71875,4.33388158,19,10,15,11,2,0,8,4,15,2,2,0,11,6,0,9,0,0,0.526315789,0.5,0.026315789
163,7,10,-3,w,15.05555556,9.523809524,5.531746036,24,8,9,7,1,0,20,5,17,5,2,1,4,3,-8,2,-1,-1,0.333333333,0.25,0.083333333
164,7,5,2,d,12.7,11.83333333,0.86666667,11,2,8,6,1,0,10,1,11,7,3,0,1,1,-3,-1,-2,0,0.181818182,0.1,0.081818182
165,10,7,3,l,9.523809524,15.05555556,-5.531746036,24,8,9,7,1,0,20,5,17,5,2,1,4,3,-8,2,-1,-1,0.333333333,0.25,0.083333333
166,3,6,-3,l,15.2,7.6,7.6,19,3,4,9,0,0,13,4,10,4,3,0,6,-1,-6,5,-3,0,0.157894737,0.307692308,-0.149797571
167,12,1,11,w,4.652173913,23.5,-18.84782609,16,8,9,11,2,0,5,0,12,0,1,0,11,8,-3,11,1,0,0.5,0,0.5
168,6,3,3,w,7.6,15.2,-7.6,19,3,4,9,0,0,13,4,10,4,3,0,6,-1,-6,5,-3,0,0.157894737,0.307692308,-0.149797571
169,1,12,-11,l,23.5,4.652173913,18.84782609,16,8,9,11,2,0,5,0,12,0,1,0,11,8,-3,11,1,0,0.5,0,0.5
170,5,7,-2,d,11.83333333,12.7,-0.86666667,11,2,8,6,1,0,10,1,11,7,3,0,1,1,-3,-1,-2,0,0.181818182,0.1,0.081818182
171,5,3,2,d,12.04166667,14.66666667,-2.625,4,1,10,1,3,0,14,5,17,3,2,0,-10,-4,-7,-2,1,0,0.25,0.357142857,-0.107142857
172,10,2,8,d,7.434782609,18.89473684,-11.45995423,12,2,5,11,4,0,7,2,9,2,3,0,5,0,-4,9,1,0,0.166666667,0.285714286,-0.119047619
173,2,10,-8,d,18.89473684,7.434782609,11.45995423,12,2,5,11,4,0,7,2,9,2,3,0,5,0,-4,9,1,0,0.166666667,0.285714286,-0.119047619
174,3,5,-2,d,14.66666667,12.04166667,2.625,4,1,10,1,3,0,14,5,17,3,2,0,-10,-4,-7,-2,1,0,0.25,0.357142857,-0.107142857
175,5,21,-16,l,18.57894737,6.736842105,11.84210527,7,2,8,1,1,0,21,10,10,8,1,0,-14,-8,-2,-7,0,0,0.285714286,0.476190476,-0.19047619
176,21,5,16,w,6.736842105,18.57894737,-11.84210527,7,2,8,1,1,0,21,10,10,8,1,0,-14,-8,-2,-7,0,0,0.285714286,0.476190476,-0.19047619
177,7,1,6,d,5.172413793,31.5,-26.32758621,7,2,6,3,0,0,10,4,14,1,1,0,-3,-2,-8,2,-1,0,0.285714286,0.4,-0.114285714
178,1,7,-6,d,31.5,5.172413793,26.32758621,7,2,6,3,0,0,10,4,14,1,1,0,-3,-2,-8,2,-1,0,0.285714286,0.4,-0.114285714
179,8,6,2,l,5.944444444,12.21428571,-6.269841266,8,2,10,7,4,0,9,3,12,12,4,0,-1,-1,-2,-5,0,0,0.25,0.333333333,-0.083333333
180,6,8,-2,w,12.21428571,5.944444444,6.269841266,8,2,10,7,4,0,9,3,12,12,4,0,-1,-1,-2,-5,0,0,0.25,0.333333333,-0.083333333
181,9,1,8,w,3.189189189,17.04761905,-13.85842986,6,3,3,2,0,1,25,15,12,7,0,0,-19,-12,-9,-5,0,1,0.5,0.6,-0.1
182,1,9,-8,l,17.04761905,3.189189189,13.85842986,6,3,3,2,0,1,25,15,12,7,0,0,-19,-12,-9,-5,0,1,0.5,0.6,-0.1
183,3,18,-15,l,26.7,8.083333333,18.61666667,25,9,10,13,1,1,11,5,5,7,1,0,14,4,5,6,0,1,0.36,0.454545455,-0.094545455
184,18,3,15,w,8.083333333,26.7,-18.61666667,25,9,10,13,1,1,11,5,5,7,1,0,14,4,5,6,0,1,0.36,0.454545455,-0.094545455
185,3,5,-2,d,9.368421053,13.15384615,-3.785425097,7,3,14,5,5,0,15,5,8,10,3,0,-8,-2,6,-5,2,0,0.428571429,0.333333333,0.095238096
186,4,7,-3,w,8.464285714,11.67857143,-3.214285716,8,4,12,0,2,0,10,6,12,5,1,0,-2,-2,0,-5,1,0,0.5,0.6,-0.1
187,7,4,3,l,11.67857143,8.464285714,3.214285716,8,4,12,0,2,0,10,6,12,5,1,0,-2,-2,0,-5,1,0,0.5,0.6,-0.1
188,7,9,-2,d,14.42857143,10.125,4.30357143,12,4,7,10,2,0,10,4,10,4,2,0,2,0,-3,6,0,0,0.333333333,0.4,-0.066666667
189,5,3,2,d,13.15384615,9.368421053,3.785425097,7,3,14,5,5,0,15,5,8,10,3,0,-8,-2,6,-5,2,0,0.428571429,0.333333333,0.095238096
190,9,7,2,d,10.125,14.42857143,-4.30357143,12,4,7,10,2,0,10,4,10,4,2,0,2,0,-3,6,0,0,0.333333333,0.4,-0.066666667
191,8,6,2,l,15.96,10.47368421,5.48631579,13,5,7,5,3,0,16,7,8,6,2,0,-3,-2,-1,-1,1,0,0.384615385,0.4375,-0.052884615
192,6,8,-2,w,10.47368421,15.96,-5.48631579,13,5,7,5,3,0,16,7,8,6,2,0,-3,-2,-1,-1,1,0,0.384615385,0.4375,-0.052884615
193,3,6,-3,d,38.625,9.6,29.025,13,2,8,3,2,1,13,5,15,6,2,0,0,-3,-7,-3,0,1,0.153846154,0.384615385,-0.230769231
194,6,3,3,d,9.6,38.625,-29.025,13,2,8,3,2,1,13,5,15,6,2,0,0,-3,-7,-3,0,1,0.153846154,0.384615385,-0.230769231
195,8,1,7,d,7.666666667,26.3,-18.63333333,15,6,18,12,2,0,10,4,9,5,0,0,5,2,9,7,2,0,0.4,0.4,0
196,1,8,-7,d,26.3,7.666666667,18.63333333,15,6,18,12,2,0,10,4,9,5,0,0,5,2,9,7,2,0,0.4,0.4,0
197,13,4,9,w,5.068965517,32.3,-27.23103448,21,13,9,8,3,0,11,4,11,3,3,0,10,9,-2,5,0,0,0.619047619,0.363636364,0.255411255
198,6,6,0,w,9.5,8.653846154,0.846153846,10,3,13,1,2,0,21,11,10,10,2,0,-11,-8,3,-9,0,0,0.3,0.523809524,-0.223809524
199,6,6,0,l,8.653846154,9.5,-0.846153846,10,3,13,1,2,0,21,11,10,10,2,0,-11,-8,3,-9,0,0,0.3,0.523809524,-0.223809524
200,4,13,-9,l,32.3,5.068965517,27.23103448,21,13,9,8,3,0,11,4,11,3,3,0,10,9,-2,5,0,0,0.619047619,0.363636364,0.255411255
201,3,4,-1,w,8.259259259,8.5,-0.240740741,12,6,14,4,4,0,15,4,12,10,3,0,-3,2,2,-6,1,0,0.5,0.266666667,0.233333333
202,4,3,1,l,8.5,8.259259259,0.240740741,12,6,14,4,4,0,15,4,12,10,3,0,-3,2,2,-6,1,0,0.5,0.266666667,0.233333333
203,9,6,3,d,14.07142857,11.76,2.31142857,10,4,6,8,0,0,25,8,15,9,2,0,-15,-4,-9,-1,-2,0,0.4,0.32,0.08
204,2,16,-14,l,20.92857143,4.4,16.52857143,5,2,12,2,1,0,25,6,9,10,2,0,-20,-4,3,-8,-1,0,0.4,0.24,0.16
205,15,5,10,w,6.967741935,15.21052632,-8.242784385,21,5,11,8,0,0,7,0,8,3,1,0,14,5,3,5,-1,0,0.238095238,0,0.238095238
206,3,6,-3,l,8.5,17.71428571,-9.21428571,13,6,8,7,1,0,6,0,12,6,2,0,7,6,-4,1,-1,0,0.461538462,0,0.461538462
207,16,2,14,w,4.4,20.92857143,-16.52857143,5,2,12,2,1,0,25,6,9,10,2,0,-20,-4,3,-8,-1,0,0.4,0.24,0.16
208,31,2,29,w,3.192307692,17.75,-14.55769231,26,4,11,17,3,0,3,3,10,0,1,0,23,1,1,17,2,0,0.153846154,1,-0.846153846
209,5,17,-12,w,14.47058824,4.166666667,10.30392157,16,6,10,7,2,0,12,9,7,3,1,0,4,-3,3,4,1,0,0.375,0.75,-0.375
210,5,15,-10,l,15.21052632,6.967741935,8.242784385,21,5,11,8,0,0,7,0,8,3,1,0,14,5,3,5,-1,0,0.238095238,0,0.238095238
211,6,3,3,w,17.71428571,8.5,9.21428571,13,6,8,7,1,0,6,0,12,6,2,0,7,6,-4,1,-1,0,0.461538462,0,0.461538462
212,2,31,-29,l,17.75,3.192307692,14.55769231,26,4,11,17,3,0,3,3,10,0,1,0,23,1,1,17,2,0,0.153846154,1,-0.846153846
213,17,5,12,l,4.166666667,14.47058824,-10.30392157,16,6,10,7,2,0,12,9,7,3,1,0,4,-3,3,4,1,0,0.375,0.75,-0.375
214,6,9,-3,d,11.76,14.07142857,-2.31142857,10,4,6,8,0,0,25,8,15,9,2,0,-15,-4,-9,-1,-2,0,0.4,0.32,0.08
215,8,6,2,w,11.26315789,20.2,-8.93684211,12,3,8,1,4,0,16,10,5,6,2,0,-4,-7,3,-5,2,0,0.25,0.625,-0.375
216,6,8,-2,l,20.2,11.26315789,8.93684211,12,3,8,1,4,0,16,10,5,6,2,0,-4,-7,3,-5,2,0,0.25,0.625,-0.375
217,5,5,0,l,17.8,6.413793103,11.3862069,12,3,15,5,2,0,14,5,16,6,2,0,-2,-2,-1,-1,0,0,0.25,0.357142857,-0.107142857
218,5,5,0,w,6.413793103,17.8,-11.3862069,12,3,15,5,2,0,14,5,16,6,2,0,-2,-2,-1,-1,0,0,0.25,0.357142857,-0.107142857
219,8,1,7,d,11.24,10.22222222,1.01777778,7,3,9,5,1,0,4,2,8,2,2,1,3,1,1,3,-1,-1,0.428571429,0.5,-0.071428571
220,1,8,-7,d,10.22222222,11.24,-1.01777778,7,3,9,5,1,0,4,2,8,2,2,1,3,1,1,3,-1,-1,0.428571429,0.5,-0.071428571
221,11,3,8,l,7.578947368,15.54545455,-7.966507182,17,5,7,10,1,0,12,2,13,4,2,1,5,3,-6,6,-1,-1,0.294117647,0.166666667,0.12745098
222,3,11,-8,w,15.54545455,7.578947368,7.966507182,17,5,7,10,1,0,12,2,13,4,2,1,5,3,-6,6,-1,-1,0.294117647,0.166666667,0.12745098
223,11,3,8,w,7.75,13.91304348,-6.16304348,23,5,9,7,3,0,3,1,17,0,2,0,20,4,-8,7,1,0,0.217391304,0.333333333,-0.115942029
224,3,11,-8,l,13.91304348,7.75,6.16304348,23,5,9,7,3,0,3,1,17,0,2,0,20,4,-8,7,1,0,0.217391304,0.333333333,-0.115942029
225,10,5,5,l,7.823529412,18.88235294,-11.05882353,20,9,10,5,2,0,16,3,5,4,0,0,4,6,5,1,2,0,0.45,0.1875,0.2625
226,5,5,0,w,9.083333333,5.708333333,3.375,14,12,17,11,2,0,7,4,10,4,1,0,7,8,7,7,1,0,0.857142857,0.571428571,0.285714286
227,6,1,5,w,6.516129032,9.941176471,-3.425047439,4,3,12,5,1,0,24,5,12,9,1,0,-20,-2,0,-4,0,0,0.75,0.208333333,0.541666667
228,5,10,-5,w,18.88235294,7.823529412,11.05882353,20,9,10,5,2,0,16,3,5,4,0,0,4,6,5,1,2,0,0.45,0.1875,0.2625
229,6,4,2,d,11.51724138,9.529411765,1.987829615,17,5,6,4,2,0,14,4,9,4,2,0,3,1,-3,0,0,0,0.294117647,0.285714286,0.008403361
230,1,6,-5,l,9.941176471,6.516129032,3.425047439,4,3,12,5,1,0,24,5,12,9,1,0,-20,-2,0,-4,0,0,0.75,0.208333333,0.541666667
231,4,6,-2,d,9.529411765,11.51724138,-1.987829615,17,5,6,4,2,0,14,4,9,4,2,0,3,1,-3,0,0,0,0.294117647,0.285714286,0.008403361
232,5,5,0,l,5.708333333,9.083333333,-3.375,14,12,17,11,2,0,7,4,10,4,1,0,7,8,7,7,1,0,0.857142857,0.571428571,0.285714286
233,10,14,-4,l,17.14285714,8.088235294,9.054621846,19,7,10,5,1,0,8,1,10,4,1,0,11,6,0,1,0,0,0.368421053,0.125,0.243421053
234,14,10,4,w,8.088235294,17.14285714,-9.054621846,19,7,10,5,1,0,8,1,10,4,1,0,11,6,0,1,0,0,0.368421053,0.125,0.243421053
235,0,8,-8,l,6.3,6.59375,-0.29375,17,5,17,6,4,0,13,4,8,3,3,0,4,1,9,3,1,0,0.294117647,0.307692308,-0.013574661
236,2,9,-7,l,5.314285714,11.96153846,-6.647252746,21,11,10,5,2,0,6,2,14,2,5,0,15,9,-4,3,-3,0,0.523809524,0.333333333,0.190476191
237,9,2,7,w,11.96153846,5.314285714,6.647252746,21,11,10,5,2,0,6,2,14,2,5,0,15,9,-4,3,-3,0,0.523809524,0.333333333,0.190476191
238,8,0,8,w,6.59375,6.3,0.29375,17,5,17,6,4,0,13,4,8,3,3,0,4,1,9,3,1,0,0.294117647,0.307692308,-0.013574661
239,6,9,-3,w,20.46153846,12.04761905,8.41391941,12,5,10,4,0,0,18,3,5,13,2,0,-6,2,5,-9,-2,0,0.416666667,0.166666667,0.25
240,9,6,3,l,12.04761905,20.46153846,-8.41391941,12,5,10,4,0,0,18,3,5,13,2,0,-6,2,5,-9,-2,0,0.416666667,0.166666667,0.25
241,3,6,-3,w,9.086956522,11.33333333,-2.246376808,11,4,12,3,3,0,15,6,14,7,2,0,-4,-2,-2,-4,1,0,0.363636364,0.4,-0.036363636
242,6,3,3,l,11.33333333,9.086956522,2.246376808,11,4,12,3,3,0,15,6,14,7,2,0,-4,-2,-2,-4,1,0,0.363636364,0.4,-0.036363636
243,3,10,-7,d,6,7.342857143,-1.342857143,12,5,13,6,6,0,21,6,19,8,2,0,-9,-1,-6,-2,4,0,0.416666667,0.285714286,0.130952381
244,3,7,-4,l,14.04347826,13.7,0.34347826,9,2,10,5,2,1,17,7,12,9,1,0,-8,-5,-2,-4,1,1,0.222222222,0.411764706,-0.189542484
245,8,9,-1,l,16.46666667,27,-10.53333333,7,0,9,6,2,0,19,9,1,7,0,0,-12,-9,8,-1,2,0,0,0.473684211,-0.473684211
246,2,5,-3,w,11.625,5.947368421,5.677631579,15,4,14,7,0,0,11,5,13,5,3,0,4,-1,1,2,-3,0,0.266666667,0.454545455,-0.187878788
247,8,11,-3,l,21.92307692,10.11111111,11.81196581,16,6,8,9,0,0,12,4,7,8,1,0,4,2,1,1,-1,0,0.375,0.333333333,0.041666667
248,15,4,11,l,5.956521739,8.217391304,-2.260869565,18,7,12,7,3,0,13,5,11,7,5,0,5,2,1,0,-2,0,0.388888889,0.384615385,0.004273504
249,9,8,1,w,27,16.46666667,10.53333333,7,0,9,6,2,0,19,9,1,7,0,0,-12,-9,8,-1,2,0,0,0.473684211,-0.473684211
250,11,8,3,w,10.11111111,21.92307692,-11.81196581,16,6,8,9,0,0,12,4,7,8,1,0,4,2,1,1,-1,0,0.375,0.333333333,0.041666667
251,4,15,-11,w,8.217391304,5.956521739,2.260869565,18,7,12,7,3,0,13,5,11,7,5,0,5,2,1,0,-2,0,0.388888889,0.384615385,0.004273504
252,10,3,7,d,7.342857143,6,1.342857143,12,5,13,6,6,0,21,6,19,8,2,0,-9,-1,-6,-2,4,0,0.416666667,0.285714286,0.130952381
253,5,2,3,l,5.947368421,11.625,-5.677631579,15,4,14,7,0,0,11,5,13,5,3,0,4,-1,1,2,-3,0,0.266666667,0.454545455,-0.187878788
254,7,3,4,w,13.7,14.04347826,-0.34347826,9,2,10,5,2,1,17,7,12,9,1,0,-8,-5,-2,-4,1,1,0.222222222,0.411764706,-0.189542484
255,6,14,-8,l,18.63157895,16.33333333,2.29824562,15,4,5,8,1,0,11,2,9,2,1,0,4,2,-4,6,0,0,0.266666667,0.181818182,0.084848485
256,14,6,8,w,16.33333333,18.63157895,-2.29824562,15,4,5,8,1,0,11,2,9,2,1,0,4,2,-4,6,0,0,0.266666667,0.181818182,0.084848485
257,6,3,3,d,8.631578947,10.48387097,-1.852292023,12,8,13,6,1,0,11,5,10,3,2,0,1,3,3,3,-1,0,0.666666667,0.454545455,0.212121212
258,3,6,-3,d,10.48387097,8.631578947,1.852292023,12,8,13,6,1,0,11,5,10,3,2,0,1,3,3,3,-1,0,0.666666667,0.454545455,0.212121212
259,14,3,11,w,7.333333333,17.6,-10.26666667,17,8,10,11,1,0,11,5,9,6,1,0,6,3,1,5,0,0,0.470588235,0.454545455,0.01604278
260,3,14,-11,l,17.6,7.333333333,10.26666667,17,8,10,11,1,0,11,5,9,6,1,0,6,3,1,5,0,0,0.470588235,0.454545455,0.01604278
261,12,2,10,d,4.115384615,38.55555556,-34.44017095,6,3,4,1,1,0,24,9,6,10,2,0,-18,-6,-2,-9,-1,0,0.5,0.375,0.125
262,2,12,-10,d,38.55555556,4.115384615,34.44017095,6,3,4,1,1,0,24,9,6,10,2,0,-18,-6,-2,-9,-1,0,0.5,0.375,0.125
263,6,9,-3,l,8.5625,8.888888889,-0.326388889,15,5,10,4,0,0,20,6,12,8,2,0,-5,-1,-2,-4,-2,0,0.333333333,0.3,0.033333333
264,3,11,-8,l,15.05555556,14.91666667,0.13888889,15,7,3,4,0,1,12,5,10,5,0,0,3,2,-7,-1,0,1,0.466666667,0.416666667,0.05
265,5,6,-1,l,8.375,7.291666667,1.083333333,15,4,13,5,2,0,7,2,10,6,0,0,8,2,3,-1,2,0,0.266666667,0.285714286,-0.019047619
266,6,3,3,l,11.35714286,11.20588235,0.15126051,19,6,0,9,0,0,5,4,16,3,3,0,14,2,-16,6,-3,0,0.315789474,0.8,-0.484210526
267,6,5,1,w,7.291666667,8.375,-1.083333333,15,4,13,5,2,0,7,2,10,6,0,0,8,2,3,-1,2,0,0.266666667,0.285714286,-0.019047619
268,11,3,8,w,14.91666667,15.05555556,-0.13888889,15,7,3,4,0,1,12,5,10,5,0,0,3,2,-7,-1,0,1,0.466666667,0.416666667,0.05
269,9,6,3,w,8.888888889,8.5625,0.326388889,15,5,10,4,0,0,20,6,12,8,2,0,-5,-1,-2,-4,-2,0,0.333333333,0.3,0.033333333
270,3,6,-3,w,11.20588235,11.35714286,-0.15126051,19,6,0,9,0,0,5,4,16,3,3,0,14,2,-16,6,-3,0,0.315789474,0.8,-0.484210526
271,8,5,3,w,7.555555556,14.2,-6.644444444,11,6,6,6,1,0,6,3,10,7,0,0,5,3,-4,-1,1,0,0.545454545,0.5,0.045454545
272,5,8,-3,l,14.2,7.555555556,6.644444444,11,6,6,6,1,0,6,3,10,7,0,0,5,3,-4,-1,1,0,0.545454545,0.5,0.045454545
273,10,2,8,d,7.884615385,24.66666667,-16.78205129,15,8,8,7,2,0,16,7,10,12,1,0,-1,1,-2,-5,1,0,0.533333333,0.4375,0.095833333
274,2,10,-8,d,24.66666667,7.884615385,16.78205129,15,8,8,7,2,0,16,7,10,12,1,0,-1,1,-2,-5,1,0,0.533333333,0.4375,0.095833333
275,8,4,4,d,7.891891892,7.571428571,0.320463321,13,3,12,7,1,0,9,4,18,2,4,0,4,-1,-6,5,-3,0,0.230769231,0.444444444,-0.213675213
276,4,8,-4,d,7.571428571,7.891891892,-0.320463321,13,3,12,7,1,0,9,4,18,2,4,0,4,-1,-6,5,-3,0,0.230769231,0.444444444,-0.213675213
277,3,13,-10,d,12,6.652173913,5.347826087,16,6,16,9,4,0,9,3,8,9,1,0,7,3,8,0,3,0,0.375,0.333333333,0.041666667
278,1,9,-8,l,18.35,5.608695652,12.74130435,16,6,7,4,0,0,11,3,9,4,1,0,5,3,-2,0,-1,0,0.375,0.272727273,0.102272727
279,9,1,8,w,5.608695652,18.35,-12.74130435,16,6,7,4,0,0,11,3,9,4,1,0,5,3,-2,0,-1,0,0.375,0.272727273,0.102272727
280,13,3,10,d,6.652173913,12,-5.347826087,16,6,16,9,4,0,9,3,8,9,1,0,7,3,8,0,3,0,0.375,0.333333333,0.041666667
281,10,6,4,l,5.619047619,20.33333333,-14.71428571,7,2,6,6,3,1,6,3,15,9,3,0,1,-1,-9,-3,0,1,0.285714286,0.5,-0.214285714
282,6,10,-4,w,20.33333333,5.619047619,14.71428571,7,2,6,6,3,1,6,3,15,9,3,0,1,-1,-9,-3,0,1,0.285714286,0.5,-0.214285714
283,3,13,-10,l,25.9375,11.2,14.7375,4,2,9,3,1,0,17,8,6,6,1,0,-13,-6,3,-3,0,0,0.5,0.470588235,0.029411765
284,13,3,10,w,11.2,25.9375,-14.7375,4,2,9,3,1,0,17,8,6,6,1,0,-13,-6,3,-3,0,0,0.5,0.470588235,0.029411765
285,2,14,-12,l,13.89285714,6.961538462,6.931318678,25,9,18,9,2,0,9,3,10,5,1,0,16,6,8,4,1,0,0.36,0.333333333,0.026666667
286,14,2,12,w,6.961538462,13.89285714,-6.931318678,25,9,18,9,2,0,9,3,10,5,1,0,16,6,8,4,1,0,0.36,0.333333333,0.026666667
287,9,4,5,w,7.19047619,13.54166667,-6.35119048,12,6,13,7,3,0,4,1,16,2,2,0,8,5,-3,5,1,0,0.5,0.25,0.25
288,1,2,-1,w,7.368421053,8.481481481,-1.113060428,12,7,9,4,0,0,8,5,9,3,1,0,4,2,0,1,-1,0,0.583333333,0.625,-0.041666667
289,3,9,-6,l,13.83333333,9.305555556,4.527777774,14,5,12,6,1,0,10,3,7,1,1,0,4,2,5,5,0,0,0.357142857,0.3,0.057142857
290,9,3,6,w,9.305555556,13.83333333,-4.527777774,14,5,12,6,1,0,10,3,7,1,1,0,4,2,5,5,0,0,0.357142857,0.3,0.057142857
291,2,1,1,l,8.481481481,7.368421053,1.113060428,12,7,9,4,0,0,8,5,9,3,1,0,4,2,0,1,-1,0,0.583333333,0.625,-0.041666667
292,4,9,-5,l,13.54166667,7.19047619,6.35119048,12,6,13,7,3,0,4,1,16,2,2,0,8,5,-3,5,1,0,0.5,0.25,0.25
293,4,5,-1,l,9.846153846,9.258064516,0.58808933,13,7,8,5,1,0,6,3,9,4,2,0,7,4,-1,1,-1,0,0.538461538,0.5,0.038461538
294,5,4,1,w,9.258064516,9.846153846,-0.58808933,13,7,8,5,1,0,6,3,9,4,2,0,7,4,-1,1,-1,0,0.538461538,0.5,0.038461538
295,6,10,-4,l,9,9.684210526,-0.684210526,11,5,13,5,1,0,12,4,17,6,2,0,-1,1,-4,-1,-1,0,0.454545455,0.333333333,0.121212122
296,10,6,4,w,9.684210526,9,0.684210526,11,5,13,5,1,0,12,4,17,6,2,0,-1,1,-4,-1,-1,0,0.454545455,0.333333333,0.121212122
297,3,13,-10,w,60,7.3125,52.6875,13,6,10,8,2,0,6,4,6,1,0,0,7,2,4,7,2,0,0.461538462,0.666666667,-0.205128205
298,13,3,10,l,7.3125,60,-52.6875,13,6,10,8,2,0,6,4,6,1,0,0,7,2,4,7,2,0,0.461538462,0.666666667,-0.205128205
299,6,4,2,l,13.9375,8.392857143,5.544642857,12,5,10,9,3,0,20,9,11,9,1,0,-8,-4,-1,0,2,0,0.416666667,0.45,-0.033333333
300,4,6,-2,w,8.392857143,13.9375,-5.544642857,12,5,10,9,3,0,20,9,11,9,1,0,-8,-4,-1,0,2,0,0.416666667,0.45,-0.033333333
301,17,5,12,l,4.611111111,8.974358974,-4.363247863,13,7,14,1,3,0,15,4,9,5,0,0,-2,3,5,-4,3,0,0.538461538,0.266666667,0.271794871
302,5,17,-12,w,8.974358974,4.611111111,4.363247863,13,7,14,1,3,0,15,4,9,5,0,0,-2,3,5,-4,3,0,0.538461538,0.266666667,0.271794871
303,2,19,-17,l,43.91666667,9.352941176,34.56372549,3,0,5,1,0,0,21,9,6,3,1,0,-18,-9,-1,-2,-1,0,0,0.428571429,-0.428571429
304,1,3,-2,l,11.2962963,11,0.2962963,13,7,12,1,1,0,7,1,8,1,1,0,6,6,4,0,0,0,0.538461538,0.142857143,0.395604395
305,2,7,-5,d,9.05,10.5,-1.45,13,3,15,6,4,0,3,0,16,2,2,0,10,3,-1,4,2,0,0.230769231,0,0.230769231
306,19,2,17,w,9.352941176,43.91666667,-34.56372549,3,0,5,1,0,0,21,9,6,3,1,0,-18,-9,-1,-2,-1,0,0,0.428571429,-0.428571429
307,3,1,2,w,11,11.2962963,-0.2962963,13,7,12,1,1,0,7,1,8,1,1,0,6,6,4,0,0,0,0.538461538,0.142857143,0.395604395
308,7,2,5,d,10.5,9.05,1.45,13,3,15,6,4,0,3,0,16,2,2,0,10,3,-1,4,2,0,0.230769231,0,0.230769231
309,23,8,15,l,3.742857143,20.84615385,-17.10329671,22,5,10,16,3,0,11,7,10,3,2,0,11,-2,0,13,1,0,0.227272727,0.636363636,-0.409090909
310,8,23,-15,w,20.84615385,3.742857143,17.10329671,22,5,10,16,3,0,11,7,10,3,2,0,11,-2,0,13,1,0,0.227272727,0.636363636,-0.409090909
311,12,17,-5,l,8.666666667,4.296296296,4.370370371,15,2,21,8,6,0,23,8,15,5,2,0,-8,-6,6,3,4,0,0.133333333,0.347826087,-0.214492754
312,17,12,5,w,4.296296296,8.666666667,-4.370370371,15,2,21,8,6,0,23,8,15,5,2,0,-8,-6,6,3,4,0,0.133333333,0.347826087,-0.214492754
313,3,6,-3,w,13.8,4.866666667,8.933333333,12,6,11,3,1,0,19,4,17,12,3,0,-7,2,-6,-9,-2,0,0.5,0.210526316,0.289473684
314,7,2,5,l,12.375,11.12,1.255,14,4,6,9,0,0,9,3,12,1,4,0,5,1,-6,8,-4,0,0.285714286,0.333333333,-0.047619047
315,2,7,-5,w,11.12,12.375,-1.255,14,4,6,9,0,0,9,3,12,1,4,0,5,1,-6,8,-4,0,0.285714286,0.333333333,-0.047619047
316,6,3,3,l,4.866666667,13.8,-8.933333333,12,6,11,3,1,0,19,4,17,12,3,0,-7,2,-6,-9,-2,0,0.5,0.210526316,0.289473684
317,6,11,-5,d,5.866666667,23.13333333,-17.26666666,13,4,10,3,3,0,13,5,7,4,0,0,0,-1,3,-1,3,0,0.307692308,0.384615385,-0.076923077
318,11,6,5,d,23.13333333,5.866666667,17.26666666,13,4,10,3,3,0,13,5,7,4,0,0,0,-1,3,-1,3,0,0.307692308,0.384615385,-0.076923077
319,7,4,3,w,23.16666667,12.13513514,11.03153153,11,4,12,4,2,0,10,3,6,3,0,0,1,1,6,1,2,0,0.363636364,0.3,0.063636364
320,4,7,-3,l,12.13513514,23.16666667,-11.03153153,11,4,12,4,2,0,10,3,6,3,0,0,1,1,6,1,2,0,0.363636364,0.3,0.063636364
321,10,7,3,w,5.038461538,17.77272727,-12.73426573,16,6,8,6,2,0,8,2,6,3,1,0,8,4,2,3,1,0,0.375,0.25,0.125
322,7,10,-3,l,17.77272727,5.038461538,12.73426573,16,6,8,6,2,0,8,2,6,3,1,0,8,4,2,3,1,0,0.375,0.25,0.125
323,1,13,-12,l,10.85,8,2.85,7,3,10,3,2,0,8,0,9,2,2,0,-1,3,1,1,0,0,0.428571429,0,0.428571429
324,3,6,-3,w,17.21052632,4.533333333,12.67719299,18,5,9,9,1,0,11,2,14,4,2,0,7,3,-5,5,-1,0,0.277777778,0.181818182,0.095959596
325,2,2,0,w,7.148148148,10.45,-3.301851852,7,4,15,4,0,0,9,0,12,3,2,0,-2,4,3,1,-2,0,0.571428571,0,0.571428571
326,6,3,3,l,4.533333333,17.21052632,-12.67719299,18,5,9,9,1,0,11,2,14,4,2,0,7,3,-5,5,-1,0,0.277777778,0.181818182,0.095959596
327,5,7,-2,d,7.033333333,11.5,-4.466666667,18,5,11,12,0,0,10,3,15,4,4,0,8,2,-4,8,-4,0,0.277777778,0.3,-0.022222222
328,2,2,0,l,10.45,7.148148148,3.301851852,7,4,15,4,0,0,9,0,12,3,2,0,-2,4,3,1,-2,0,0.571428571,0,0.571428571
329,7,5,2,d,11.5,7.033333333,4.466666667,18,5,11,12,0,0,10,3,15,4,4,0,8,2,-4,8,-4,0,0.277777778,0.3,-0.022222222
330,13,1,12,w,8,10.85,-2.85,7,3,10,3,2,0,8,0,9,2,2,0,-1,3,1,1,0,0,0.428571429,0,0.428571429
331,7,8,-1,l,7.722222222,11.95,-4.227777778,11,2,9,5,1,0,11,4,14,8,3,0,0,-2,-5,-3,-2,0,0.181818182,0.363636364,-0.181818182
332,8,7,1,w,11.95,7.722222222,4.227777778,11,2,9,5,1,0,11,4,14,8,3,0,0,-2,-5,-3,-2,0,0.181818182,0.363636364,-0.181818182
333,2,4,-2,d,11.25,8.909090909,2.340909091,24,8,10,6,1,0,8,3,12,5,2,0,16,5,-2,1,-1,0,0.333333333,0.375,-0.041666667
334,4,2,2,d,8.909090909,11.25,-2.340909091,24,8,10,6,1,0,8,3,12,5,2,0,16,5,-2,1,-1,0,0.333333333,0.375,-0.041666667
335,10,8,2,w,8.692307692,6.677419355,2.014888337,18,5,14,11,4,0,9,5,10,2,4,0,9,0,4,9,0,0,0.277777778,0.555555556,-0.277777778
336,8,10,-2,l,6.677419355,8.692307692,-2.014888337,18,5,14,11,4,0,9,5,10,2,4,0,9,0,4,9,0,0,0.277777778,0.555555556,-0.277777778
337,1,6,-5,l,18.13043478,8.513513514,9.616921266,6,1,9,3,1,0,14,7,24,3,4,0,-8,-6,-15,0,-3,0,0.166666667,0.5,-0.333333333
338,6,1,5,w,8.513513514,18.13043478,-9.616921266,6,1,9,3,1,0,14,7,24,3,4,0,-8,-6,-15,0,-3,0,0.166666667,0.5,-0.333333333
339,11,5,6,d,5.25,19.3125,-14.0625,11,4,7,3,1,0,15,10,12,7,1,0,-4,-6,-5,-4,0,0,0.363636364,0.666666667,-0.303030303
340,5,11,-6,d,19.3125,5.25,14.0625,11,4,7,3,1,0,15,10,12,7,1,0,-4,-6,-5,-4,0,0,0.363636364,0.666666667,-0.303030303
341,1,8,-7,d,8.043478261,12.42307692,-4.379598659,9,0,10,5,2,0,6,2,11,4,3,0,3,-2,-1,1,-1,0,0,0.333333333,-0.333333333
342,8,1,7,d,12.42307692,8.043478261,4.379598659,9,0,10,5,2,0,6,2,11,4,3,0,3,-2,-1,1,-1,0,0,0.333333333,-0.333333333
343,6,5,1,l,10.4375,12,-1.5625,19,6,16,7,2,0,17,8,15,5,1,0,2,-2,1,2,1,0,0.315789474,0.470588235,-0.154798761
344,6,0,6,l,5.555555556,8.392857143,-2.837301587,3,0,13,4,2,0,2,1,21,5,4,0,1,-1,-8,-1,-2,0,0,0.5,-0.5
345,9,1,8,l,8.533333333,20.22222222,-11.68888889,9,2,6,4,1,0,7,2,11,3,3,0,2,0,-5,1,-2,0,0.222222222,0.285714286,-0.063492064
346,0,6,-6,w,8.392857143,5.555555556,2.837301587,3,0,13,4,2,0,2,1,21,5,4,0,1,-1,-8,-1,-2,0,0,0.5,-0.5
347,14,6,8,l,8.652173913,12.5,-3.847826087,8,3,12,4,2,0,16,4,11,5,0,0,-8,-1,1,-1,2,0,0.375,0.25,0.125
348,6,14,-8,w,12.5,8.652173913,3.847826087,8,3,12,4,2,0,16,4,11,5,0,0,-8,-1,1,-1,2,0,0.375,0.25,0.125
349,4,2,2,l,14.58823529,9.461538462,5.126696828,13,7,7,3,2,0,14,4,14,11,4,0,-1,3,-7,-8,-2,0,0.538461538,0.285714286,0.252747252
350,1,9,-8,w,20.22222222,8.533333333,11.68888889,9,2,6,4,1,0,7,2,11,3,3,0,2,0,-5,1,-2,0,0.222222222,0.285714286,-0.063492064
351,5,6,-1,w,12,10.4375,1.5625,19,6,16,7,2,0,17,8,15,5,1,0,2,-2,1,2,1,0,0.315789474,0.470588235,-0.154798761
352,2,4,-2,w,9.461538462,14.58823529,-5.126696828,13,7,7,3,2,0,14,4,14,11,4,0,-1,3,-7,-8,-2,0,0.538461538,0.285714286,0.252747252
353,0,17,-17,l,32.91666667,8.625,24.29166667,23,12,14,6,2,0,5,2,9,1,2,0,18,10,5,5,0,0,0.52173913,0.4,0.12173913
354,17,0,17,w,8.625,32.91666667,-24.29166667,23,12,14,6,2,0,5,2,9,1,2,0,18,10,5,5,0,0,0.52173913,0.4,0.12173913
355,8,8,0,l,5.416666667,8.875,-3.458333333,11,3,16,3,3,0,17,8,11,5,1,0,-6,-5,5,-2,2,0,0.272727273,0.470588235,-0.197860962
356,8,8,0,w,8.875,5.416666667,3.458333333,11,3,16,3,3,0,17,8,11,5,1,0,-6,-5,5,-2,2,0,0.272727273,0.470588235,-0.197860962
357,8,7,1,w,10.4,12.7826087,-2.3826087,5,1,9,3,4,1,13,3,11,5,3,0,-8,-2,-2,-2,1,1,0.2,0.230769231,-0.030769231
358,7,8,-1,l,12.7826087,10.4,2.3826087,5,1,9,3,4,1,13,3,11,5,3,0,-8,-2,-2,-2,1,1,0.2,0.230769231,-0.030769231
359,2,7,-5,l,9.692307692,10.125,-0.432692308,11,5,10,9,4,0,11,5,9,2,2,0,0,0,1,7,2,0,0.454545455,0.454545455,0
360,7,2,5,w,10.125,9.692307692,0.432692308,11,5,10,9,4,0,11,5,9,2,2,0,0,0,1,7,2,0,0.454545455,0.454545455,0
361,13,9,4,d,7.653846154,23.8,-16.14615385,12,4,5,8,4,0,17,2,13,3,4,0,-5,2,-8,5,0,0,0.333333333,0.117647059,0.215686274
362,4,3,1,w,11.52173913,9.222222222,2.299516908,11,2,15,5,2,0,16,6,12,8,3,0,-5,-4,3,-3,-1,0,0.181818182,0.375,-0.193181818
363,9,13,-4,d,23.8,7.653846154,16.14615385,12,4,5,8,4,0,17,2,13,3,4,0,-5,2,-8,5,0,0,0.333333333,0.117647059,0.215686274
364,1,2,-1,l,13.08333333,5.526315789,7.557017541,21,5,15,10,0,0,6,0,14,2,0,0,15,5,1,8,0,0,0.238095238,0,0.238095238
365,10,2,8,l,5.111111111,12.53571429,-7.424603179,10,3,10,8,3,0,5,3,9,1,2,0,5,0,1,7,1,0,0.3,0.6,-0.3
366,12,8,4,w,9.941176471,9.909090909,0.032085562,13,4,5,7,0,0,10,2,10,6,2,0,3,2,-5,1,-2,0,0.307692308,0.2,0.107692308
367,2,1,1,w,5.526315789,13.08333333,-7.557017541,21,5,15,10,0,0,6,0,14,2,0,0,15,5,1,8,0,0,0.238095238,0,0.238095238
368,3,4,-1,l,9.222222222,11.52173913,-2.299516908,11,2,15,5,2,0,16,6,12,8,3,0,-5,-4,3,-3,-1,0,0.181818182,0.375,-0.193181818
369,6,6,0,d,13.2,20.42857143,-7.22857143,16,4,11,9,1,0,5,2,8,1,3,0,11,2,3,8,-2,0,0.25,0.4,-0.15
370,2,10,-8,w,12.53571429,5.111111111,7.424603179,10,3,10,8,3,0,5,3,9,1,2,0,5,0,1,7,1,0,0.3,0.6,-0.3
371,6,6,0,d,20.42857143,13.2,7.22857143,16,4,11,9,1,0,5,2,8,1,3,0,11,2,3,8,-2,0,0.25,0.4,-0.15
372,8,12,-4,l,9.909090909,9.941176471,-0.032085562,13,4,5,7,0,0,10,2,10,6,2,0,3,2,-5,1,-2,0,0.307692308,0.2,0.107692308
373,6,4,2,w,5.518518519,40.45454545,-34.93602693,22,10,10,5,2,0,7,2,7,0,2,0,15,8,3,5,0,0,0.454545455,0.285714286,0.168831169
374,4,6,-2,l,40.45454545,5.518518519,34.93602693,22,10,10,5,2,0,7,2,7,0,2,0,15,8,3,5,0,0,0.454545455,0.285714286,0.168831169
375,3,6,-3,l,20.47058824,11.43478261,9.03580563,3,0,5,2,1,0,15,6,7,8,1,0,-12,-6,-2,-6,0,0,0,0.4,-0.4
376,6,3,3,w,11.43478261,20.47058824,-9.03580563,3,0,5,2,1,0,15,6,7,8,1,0,-12,-6,-2,-6,0,0,0,0.4,-0.4
377,1,4,-3,l,18.8,13.05882353,5.74117647,20,8,7,3,0,0,7,3,13,1,1,1,13,5,-6,2,-1,-1,0.4,0.428571429,-0.028571429
378,4,1,3,w,13.05882353,18.8,-5.74117647,20,8,7,3,0,0,7,3,13,1,1,1,13,5,-6,2,-1,-1,0.4,0.428571429,-0.028571429
379,5,11,-6,l,17.125,9.375,7.75,16,6,8,9,0,0,10,2,11,2,2,0,6,4,-3,7,-2,0,0.375,0.2,0.175
380,11,5,6,w,9.375,17.125,-7.75,16,6,8,9,0,0,10,2,11,2,2,0,6,4,-3,7,-2,0,0.375,0.2,0.175
381,6,8,-2,l,16,8.76,7.24,20,6,16,6,3,1,11,2,9,3,1,0,9,4,7,3,2,1,0.3,0.181818182,0.118181818
382,2,4,-2,d,19.35714286,5.411764706,13.94537815,14,5,13,12,1,0,5,2,7,4,2,0,9,3,6,8,-1,0,0.357142857,0.4,-0.042857143
383,6,6,0,w,8.5,14.70588235,-6.20588235,20,5,13,5,2,0,22,9,13,8,2,0,-2,-4,0,-3,0,0,0.25,0.409090909,-0.159090909
384,6,6,0,l,14.70588235,8.5,6.20588235,20,5,13,5,2,0,22,9,13,8,2,0,-2,-4,0,-3,0,0,0.25,0.409090909,-0.159090909
385,4,2,2,d,5.411764706,19.35714286,-13.94537815,14,5,13,12,1,0,5,2,7,4,2,0,9,3,6,8,-1,0,0.357142857,0.4,-0.042857143
386,8,6,2,w,8.76,16,-7.24,20,6,16,6,3,1,11,2,9,3,1,0,9,4,7,3,2,1,0.3,0.181818182,0.118181818
387,8,7,1,w,7.590909091,8.941176471,-1.35026738,14,4,16,5,4,0,13,8,4,5,1,0,1,-4,12,0,3,0,0.285714286,0.615384615,-0.329670329
388,4,11,-7,d,8.466666667,9.8,-1.333333333,5,2,12,4,3,0,15,7,10,6,3,0,-10,-5,2,-2,0,0,0.4,0.466666667,-0.066666667
389,11,4,7,d,9.8,8.466666667,1.333333333,5,2,12,4,3,0,15,7,10,6,3,0,-10,-5,2,-2,0,0,0.4,0.466666667,-0.066666667
390,7,8,-1,l,8.941176471,7.590909091,1.35026738,14,4,16,5,4,0,13,8,4,5,1,0,1,-4,12,0,3,0,0.285714286,0.615384615,-0.329670329
391,3,9,-6,l,13.5,8.333333333,5.166666667,8,1,17,5,4,0,14,5,10,4,3,0,-6,-4,7,1,1,0,0.125,0.357142857,-0.232142857
392,9,3,6,w,8.333333333,13.5,-5.166666667,8,1,17,5,4,0,14,5,10,4,3,0,-6,-4,7,1,1,0,0.125,0.357142857,-0.232142857
393,7,8,-1,l,14.04347826,6.894736842,7.148741418,7,2,13,2,5,0,13,4,19,3,4,0,-6,-2,-6,-1,1,0,0.285714286,0.307692308,-0.021978022
394,8,7,1,w,6.894736842,14.04347826,-7.148741418,7,2,13,2,5,0,13,4,19,3,4,0,-6,-2,-6,-1,1,0,0.285714286,0.307692308,-0.021978022
395,14,3,11,w,6.266666667,21.33333333,-15.06666666,10,3,7,5,1,0,10,2,3,6,0,0,0,1,4,-1,1,0,0.3,0.2,0.1
396,3,14,-11,l,21.33333333,6.266666667,15.06666666,10,3,7,5,1,0,10,2,3,6,0,0,0,1,4,-1,1,0,0.3,0.2,0.1
397,9,2,7,w,10.92307692,34.57142857,-23.64835165,16,4,5,8,1,0,8,0,6,5,1,0,8,4,-1,3,0,0,0.25,0,0.25
398,2,9,-7,l,34.57142857,10.92307692,23.64835165,16,4,5,8,1,0,8,0,6,5,1,0,8,4,-1,3,0,0,0.25,0,0.25
399,5,9,-4,w,26.5,7.944444444,18.55555556,20,1,12,8,1,0,11,6,10,4,1,0,9,-5,2,4,0,0,0.05,0.545454545,-0.495454545
400,10,7,3,d,12.14814815,8.53125,3.61689815,16,5,8,5,2,0,16,5,15,3,3,0,0,0,-7,2,-1,0,0.3125,0.3125,0
401,9,5,4,l,7.944444444,26.5,-18.55555556,20,1,12,8,1,0,11,6,10,4,1,0,9,-5,2,4,0,0,0.05,0.545454545,-0.495454545
402,7,10,-3,d,8.53125,12.14814815,-3.61689815,16,5,8,5,2,0,16,5,15,3,3,0,0,0,-7,2,-1,0,0.3125,0.3125,0
403,16,2,14,w,3.588235294,39.92307692,-36.33484163,5,2,8,4,1,0,17,10,12,5,1,0,-12,-8,-4,-1,0,0,0.4,0.588235294,-0.188235294
404,2,16,-14,l,39.92307692,3.588235294,36.33484163,5,2,8,4,1,0,17,10,12,5,1,0,-12,-8,-4,-1,0,0,0.4,0.588235294,-0.188235294
405,4,4,0,w,6.375,6.434782609,-0.059782609,12,3,21,6,3,0,11,5,8,9,4,0,1,-2,13,-3,-1,0,0.25,0.454545455,-0.204545455
406,4,4,0,l,6.434782609,6.375,0.059782609,12,3,21,6,3,0,11,5,8,9,4,0,1,-2,13,-3,-1,0,0.25,0.454545455,-0.204545455
407,7,7,0,w,20.11764706,8.45,11.66764706,9,3,12,4,3,1,16,4,6,7,1,0,-7,-1,6,-3,2,1,0.333333333,0.25,0.083333333
408,7,7,0,l,8.45,20.11764706,-11.66764706,9,3,12,4,3,1,16,4,6,7,1,0,-7,-1,6,-3,2,1,0.333333333,0.25,0.083333333
409,4,8,-4,l,15.93333333,22.52631579,-6.59298246,14,7,3,9,1,0,3,2,12,2,2,0,11,5,-9,7,-1,0,0.5,0.666666667,-0.166666667
410,7,7,0,d,8,11.27272727,-3.27272727,15,4,12,2,5,0,12,3,9,5,0,0,3,1,3,-3,5,0,0.266666667,0.25,0.016666667
411,2,9,-7,l,22.52173913,10.28,12.24173913,16,7,11,3,0,0,7,2,11,6,4,0,9,5,0,-3,-4,0,0.4375,0.285714286,0.151785714
412,9,2,7,w,10.28,22.52173913,-12.24173913,16,7,11,3,0,0,7,2,11,6,4,0,9,5,0,-3,-4,0,0.4375,0.285714286,0.151785714
413,7,7,0,d,11.27272727,8,3.27272727,15,4,12,2,5,0,12,3,9,5,0,0,3,1,3,-3,5,0,0.266666667,0.25,0.016666667
414,8,4,4,w,22.52631579,15.93333333,6.59298246,14,7,3,9,1,0,3,2,12,2,2,0,11,5,-9,7,-1,0,0.5,0.666666667,-0.166666667
415,8,5,3,w,13.56521739,11.24137931,2.32383808,10,4,11,1,2,0,10,4,15,4,0,0,0,0,-4,-3,2,0,0.4,0.4,0
416,5,8,-3,l,11.24137931,13.56521739,-2.32383808,10,4,11,1,2,0,10,4,15,4,0,0,0,0,-4,-3,2,0,0.4,0.4,0
417,16,7,9,w,14.58333333,32.68421053,-18.1008772,19,7,5,8,0,0,3,2,8,4,0,0,16,5,-3,4,0,0,0.368421053,0.666666667,-0.298245614
418,7,16,-9,l,32.68421053,14.58333333,18.1008772,19,7,5,8,0,0,3,2,8,4,0,0,16,5,-3,4,0,0,0.368421053,0.666666667,-0.298245614
419,4,3,1,w,9.928571429,10.94736842,-1.018796991,13,3,11,7,1,0,7,2,6,3,0,0,6,1,5,4,1,0,0.230769231,0.285714286,-0.054945055
420,3,4,-1,l,10.94736842,9.928571429,1.018796991,13,3,11,7,1,0,7,2,6,3,0,0,6,1,5,4,1,0,0.230769231,0.285714286,-0.054945055
421,8,5,3,d,5.6875,8.818181818,-3.130681818,6,3,14,1,2,0,7,4,22,4,3,1,-1,-1,-8,-3,-1,-1,0.5,0.571428571,-0.071428571
422,5,8,-3,d,8.818181818,5.6875,3.130681818,6,3,14,1,2,0,7,4,22,4,3,1,-1,-1,-8,-3,-1,-1,0.5,0.571428571,-0.071428571
423,6,10,-4,l,17.4375,8.689655172,8.747844828,14,6,7,4,2,0,9,2,7,3,1,0,5,4,0,1,1,0,0.428571429,0.222222222,0.206349207
424,1,10,-9,l,28.81818182,9.588235294,19.22994653,18,8,7,10,0,0,7,2,4,3,3,0,11,6,3,7,-3,0,0.444444444,0.285714286,0.158730158
425,10,1,9,w,9.588235294,28.81818182,-19.22994653,18,8,7,10,0,0,7,2,4,3,3,0,11,6,3,7,-3,0,0.444444444,0.285714286,0.158730158
426,10,6,4,w,8.689655172,17.4375,-8.747844828,14,6,7,4,2,0,9,2,7,3,1,0,5,4,0,1,1,0,0.428571429,0.222222222,0.206349207
427,2,3,-1,l,12,7.727272727,4.272727273,5,5,9,2,0,0,16,10,17,4,3,0,-11,-5,-8,-2,-3,0,1,0.625,0.375
428,17,4,13,w,5,15.89473684,-10.89473684,13,6,18,4,0,0,8,3,7,2,0,0,5,3,11,2,0,0,0.461538462,0.375,0.086538462
429,2,2,0,d,16.69565217,4.733333333,11.96231884,9,4,13,5,0,0,5,1,12,2,3,0,4,3,1,3,-3,0,0.444444444,0.2,0.244444444
430,4,17,-13,l,15.89473684,5,10.89473684,13,6,18,4,0,0,8,3,7,2,0,0,5,3,11,2,0,0,0.461538462,0.375,0.086538462
431,3,2,1,w,7.727272727,12,-4.272727273,5,5,9,2,0,0,16,10,17,4,3,0,-11,-5,-8,-2,-3,0,1,0.625,0.375
432,2,2,0,d,4.733333333,16.69565217,-11.96231884,9,4,13,5,0,0,5,1,12,2,3,0,4,3,1,3,-3,0,0.444444444,0.2,0.244444444
433,21,4,17,w,12.3,29.9375,-17.6375,14,4,4,4,0,0,13,7,8,3,2,0,1,-3,-4,1,-2,0,0.285714286,0.538461538,-0.252747252
434,4,21,-17,l,29.9375,12.3,17.6375,14,4,4,4,0,0,13,7,8,3,2,0,1,-3,-4,1,-2,0,0.285714286,0.538461538,-0.252747252
435,5,7,-2,l,13.06666667,11.44,1.62666667,10,1,3,5,1,0,18,6,13,5,1,0,-8,-5,-10,0,0,0,0.1,0.333333333,-0.233333333
436,7,5,2,w,11.44,13.06666667,-1.62666667,10,1,3,5,1,0,18,6,13,5,1,0,-8,-5,-10,0,0,0,0.1,0.333333333,-0.233333333
437,1,20,-19,l,34.3125,7.633333333,26.67916667,7,1,5,2,2,0,22,12,12,4,1,0,-15,-11,-7,-2,1,0,0.142857143,0.545454545,-0.402597402
438,20,1,19,w,7.633333333,34.3125,-26.67916667,7,1,5,2,2,0,22,12,12,4,1,0,-15,-11,-7,-2,1,0,0.142857143,0.545454545,-0.402597402
439,13,9,4,d,7.294117647,9.166666667,-1.87254902,15,2,13,3,2,0,17,5,13,3,3,0,-2,-3,0,0,-1,0,0.133333333,0.294117647,-0.160784314
440,9,13,-4,d,9.166666667,7.294117647,1.87254902,15,2,13,3,2,0,17,5,13,3,3,0,-2,-3,0,0,-1,0,0.133333333,0.294117647,-0.160784314
441,6,1,5,d,9.444444444,8.972222222,0.472222222,11,4,9,4,1,0,12,4,13,5,2,0,-1,0,-4,-1,-1,0,0.363636364,0.333333333,0.030303031
442,4,7,-3,d,10.77777778,7.24137931,3.53639847,10,2,11,3,3,0,8,3,13,4,3,0,2,-1,-2,-1,0,0,0.2,0.375,-0.175
443,4,6,-2,l,13.75,9.764705882,3.985294118,16,5,10,4,2,1,6,3,10,5,2,1,10,2,0,-1,0,0,0.3125,0.5,-0.1875
444,7,4,3,d,7.24137931,10.77777778,-3.53639847,10,2,11,3,3,0,8,3,13,4,3,0,2,-1,-2,-1,0,0,0.2,0.375,-0.175
445,2,23,-21,d,29.5,4.923076923,24.57692308,25,6,9,14,1,0,5,3,7,2,2,0,20,3,2,12,-1,0,0.24,0.6,-0.36
446,4,2,2,d,8.259259259,9.8,-1.540740741,12,6,11,7,1,0,11,3,13,6,0,0,1,3,-2,1,1,0,0.5,0.272727273,0.227272727
447,23,2,21,d,4.923076923,29.5,-24.57692308,25,6,9,14,1,0,5,3,7,2,2,0,20,3,2,12,-1,0,0.24,0.6,-0.36
448,6,4,2,w,9.764705882,13.75,-3.985294118,16,5,10,4,2,1,6,3,10,5,2,1,10,2,0,-1,0,0,0.3125,0.5,-0.1875
449,1,6,-5,d,8.972222222,9.444444444,-0.472222222,11,4,9,4,1,0,12,4,13,5,2,0,-1,0,-4,-1,-1,0,0.363636364,0.333333333,0.030303031
450,2,5,-3,l,5.194444444,15.30769231,-10.11324787,11,5,13,1,2,0,8,4,12,3,1,0,3,1,1,-2,1,0,0.454545455,0.5,-0.045454545
451,2,4,-2,d,9.8,8.259259259,1.540740741,12,6,11,7,1,0,11,3,13,6,0,0,1,3,-2,1,1,0,0.5,0.272727273,0.227272727
452,5,2,3,w,15.30769231,5.194444444,10.11324787,11,5,13,1,2,0,8,4,12,3,1,0,3,1,1,-2,1,0,0.454545455,0.5,-0.045454545
453,11,3,8,l,4.233333333,23.27272727,-19.03939394,7,2,9,1,1,0,19,4,14,10,1,0,-12,-2,-5,-9,0,0,0.285714286,0.210526316,0.07518797
454,3,11,-8,w,23.27272727,4.233333333,19.03939394,7,2,9,1,1,0,19,4,14,10,1,0,-12,-2,-5,-9,0,0,0.285714286,0.210526316,0.07518797
455,3,14,-11,w,9.72,9.826086957,-0.106086957,8,5,14,4,1,0,18,8,8,5,0,0,-10,-3,6,-1,1,0,0.625,0.444444444,0.180555556
456,14,3,11,l,9.826086957,9.72,0.106086957,8,5,14,4,1,0,18,8,8,5,0,0,-10,-3,6,-1,1,0,0.625,0.444444444,0.180555556
457,12,5,7,w,11,15,-4,16,5,7,11,1,0,9,4,10,5,3,0,7,1,-3,6,-2,0,0.3125,0.444444444,-0.131944444
458,5,12,-7,l,15,11,4,16,5,7,11,1,0,9,4,10,5,3,0,7,1,-3,6,-2,0,0.3125,0.444444444,-0.131944444
459,6,1,5,w,6.173913043,9.272727273,-3.09881423,16,5,11,6,2,0,8,2,18,3,2,0,8,3,-7,3,0,0,0.3125,0.25,0.0625
460,6,4,2,w,11.12903226,6.428571429,4.700460831,11,3,9,5,1,0,21,8,12,8,1,0,-10,-5,-3,-3,0,0,0.272727273,0.380952381,-0.108225108
461,4,6,-2,l,6.428571429,11.12903226,-4.700460831,11,3,9,5,1,0,21,8,12,8,1,0,-10,-5,-3,-3,0,0,0.272727273,0.380952381,-0.108225108
462,9,8,1,l,7.833333333,4.5,3.333333333,6,0,12,0,1,0,15,6,13,8,2,0,-9,-6,-1,-8,-1,0,0,0.4,-0.4
463,5,2,3,d,11.72,15.08695652,-3.36695652,17,8,13,6,1,0,8,2,10,4,1,0,9,6,3,2,0,0,0.470588235,0.25,0.220588235
464,11,6,5,w,8.833333333,23,-14.16666667,4,1,13,5,4,0,18,5,13,13,3,0,-14,-4,0,-8,1,0,0.25,0.277777778,-0.027777778
465,2,5,-3,d,15.08695652,11.72,3.36695652,17,8,13,6,1,0,8,2,10,4,1,0,9,6,3,2,0,0,0.470588235,0.25,0.220588235
466,6,11,-5,l,23,8.833333333,14.16666667,4,1,13,5,4,0,18,5,13,13,3,0,-14,-4,0,-8,1,0,0.25,0.277777778,-0.027777778
467,8,9,-1,w,4.5,7.833333333,-3.333333333,6,0,12,0,1,0,15,6,13,8,2,0,-9,-6,-1,-8,-1,0,0,0.4,-0.4
468,1,6,-5,l,9.272727273,6.173913043,3.09881423,16,5,11,6,2,0,8,2,18,3,2,0,8,3,-7,3,0,0,0.3125,0.25,0.0625
469,2,21,-19,d,21.66666667,8.321428571,13.3452381,19,8,11,17,2,0,2,2,6,5,1,1,17,6,5,12,1,-1,0.421052632,1,-0.578947368
470,21,2,19,d,8.321428571,21.66666667,-13.3452381,19,8,11,17,2,0,2,2,6,5,1,1,17,6,5,12,1,-1,0.421052632,1,-0.578947368
471,18,2,16,w,5.954545455,15.8,-9.845454545,19,8,10,7,1,0,6,2,19,8,1,0,13,6,-9,-1,0,0,0.421052632,0.333333333,0.087719299
472,11,7,4,l,14.23529412,9.032258065,5.203036055,14,3,12,7,0,0,12,2,7,3,1,0,2,1,5,4,-1,0,0.214285714,0.166666667,0.047619047
473,7,11,-4,w,9.032258065,14.23529412,-5.203036055,14,3,12,7,0,0,12,2,7,3,1,0,2,1,5,4,-1,0,0.214285714,0.166666667,0.047619047
474,2,18,-16,l,15.8,5.954545455,9.845454545,19,8,10,7,1,0,6,2,19,8,1,0,13,6,-9,-1,0,0,0.421052632,0.333333333,0.087719299
475,3,11,-8,w,13.88461538,10.9,2.98461538,24,7,11,5,0,0,5,2,7,2,2,0,19,5,4,3,-2,0,0.291666667,0.4,-0.108333333
476,11,3,8,l,10.9,13.88461538,-2.98461538,24,7,11,5,0,0,5,2,7,2,2,0,19,5,4,3,-2,0,0.291666667,0.4,-0.108333333
477,2,4,-2,w,11.88888889,22.375,-10.48611111,10,3,6,2,0,0,13,6,11,4,1,0,-3,-3,-5,-2,-1,0,0.3,0.461538462,-0.161538462
478,4,2,2,l,22.375,11.88888889,10.48611111,10,3,6,2,0,0,13,6,11,4,1,0,-3,-3,-5,-2,-1,0,0.3,0.461538462,-0.161538462
479,11,2,9,w,7.481481481,38.35714286,-30.87566138,7,4,6,3,2,0,13,5,6,7,0,0,-6,-1,0,-4,2,0,0.571428571,0.384615385,0.186813186
480,2,11,-9,l,38.35714286,7.481481481,30.87566138,7,4,6,3,2,0,13,5,6,7,0,0,-6,-1,0,-4,2,0,0.571428571,0.384615385,0.186813186
481,8,5,3,d,14.63157895,7.848484848,6.783094102,14,4,16,4,2,0,7,3,14,6,2,0,7,1,2,-2,0,0,0.285714286,0.428571429,-0.142857143
482,5,8,-3,d,7.848484848,14.63157895,-6.783094102,14,4,16,4,2,0,7,3,14,6,2,0,7,1,2,-2,0,0,0.285714286,0.428571429,-0.142857143
483,7,8,-1,l,7.642857143,10,-2.357142857,16,6,10,1,1,1,18,5,15,8,3,0,-2,1,-5,-7,-2,1,0.375,0.277777778,0.097222222
484,8,7,1,w,10,7.642857143,2.357142857,16,6,10,1,1,1,18,5,15,8,3,0,-2,1,-5,-7,-2,1,0.375,0.277777778,0.097222222
485,9,5,4,d,6.333333333,17.33333333,-11,12,6,8,4,1,0,19,6,9,6,1,0,-7,0,-1,-2,0,0,0.5,0.315789474,0.184210526
486,6,4,2,l,11,10.31034483,0.68965517,13,3,9,9,3,0,10,3,15,5,2,0,3,0,-6,4,1,0,0.230769231,0.3,-0.069230769
487,5,2,3,w,8.285714286,9.24,-0.954285714,11,2,17,4,2,0,12,5,14,4,2,1,-1,-3,3,0,0,-1,0.181818182,0.416666667,-0.234848485
488,8,7,1,w,6.227272727,12.73913043,-6.511857703,16,9,9,6,0,0,17,4,15,11,2,0,-1,5,-6,-5,-2,0,0.5625,0.235294118,0.327205882
489,2,9,-7,d,11.31818182,7.692307692,3.625874128,15,5,10,8,2,0,19,4,15,12,1,0,-4,1,-5,-4,1,0,0.333333333,0.210526316,0.122807017
490,9,2,7,d,7.692307692,11.31818182,-3.625874128,15,5,10,8,2,0,19,4,15,12,1,0,-4,1,-5,-4,1,0,0.333333333,0.210526316,0.122807017
491,4,6,-2,w,10.31034483,11,-0.68965517,13,3,9,9,3,0,10,3,15,5,2,0,3,0,-6,4,1,0,0.230769231,0.3,-0.069230769
492,7,8,-1,l,12.73913043,6.227272727,6.511857703,16,9,9,6,0,0,17,4,15,11,2,0,-1,5,-6,-5,-2,0,0.5625,0.235294118,0.327205882
493,2,5,-3,l,9.24,8.285714286,0.954285714,11,2,17,4,2,0,12,5,14,4,2,1,-1,-3,3,0,0,-1,0.181818182,0.416666667,-0.234848485
494,5,9,-4,d,17.33333333,6.333333333,11,12,6,8,4,1,0,19,6,9,6,1,0,-7,0,-1,-2,0,0,0.5,0.315789474,0.184210526
495,7,4,3,d,7.24137931,9.344827586,-2.103448276,15,5,14,4,3,0,14,3,15,6,2,0,1,2,-1,-2,1,0,0.333333333,0.214285714,0.119047619
496,4,7,-3,d,9.344827586,7.24137931,2.103448276,15,5,14,4,3,0,14,3,15,6,2,0,1,2,-1,-2,1,0,0.333333333,0.214285714,0.119047619
497,4,4,0,d,6.636363636,11.16666667,-4.530303034,15,2,8,5,1,0,13,2,11,7,3,0,2,0,-3,-2,-2,0,0.133333333,0.153846154,-0.020512821
498,4,4,0,d,11.16666667,6.636363636,4.530303034,15,2,8,5,1,0,13,2,11,7,3,0,2,0,-3,-2,-2,0,0.133333333,0.153846154,-0.020512821
499,21,6,15,l,7.32,21.41176471,-14.09176471,3,3,8,2,2,0,18,5,14,6,3,1,-15,-2,-6,-4,-1,-1,1,0.277777778,0.722222222
500,6,21,-15,w,21.41176471,7.32,14.09176471,3,3,8,2,2,0,18,5,14,6,3,1,-15,-2,-6,-4,-1,-1,1,0.277777778,0.722222222
501,8,2,6,l,7.863636364,8.129032258,-0.265395894,14,8,11,4,0,0,10,2,12,6,1,0,4,6,-1,-2,-1,0,0.571428571,0.2,0.371428571
502,2,8,-6,w,8.129032258,7.863636364,0.265395894,14,8,11,4,0,0,10,2,12,6,1,0,4,6,-1,-2,-1,0,0.571428571,0.2,0.371428571
503,7,3,4,d,7.15,15.36363636,-8.21363636,10,2,9,3,2,0,5,2,12,2,2,0,5,0,-3,1,0,0,0.2,0.4,-0.2
504,3,7,-4,d,15.36363636,7.15,8.21363636,10,2,9,3,2,0,5,2,12,2,2,0,5,0,-3,1,0,0,0.2,0.4,-0.2
505,8,10,-2,l,10.15,9.368421053,0.781578947,16,6,10,8,2,0,10,2,8,4,2,0,6,4,2,4,0,0,0.375,0.2,0.175
506,10,8,2,w,9.368421053,10.15,-0.781578947,16,6,10,8,2,0,10,2,8,4,2,0,6,4,2,4,0,0,0.375,0.2,0.175
507,3,6,-3,d,6.5,15.38888889,-8.88888889,15,3,13,7,2,0,9,3,10,0,2,1,6,0,3,7,0,-1,0.2,0.333333333,-0.133333333
508,6,3,3,d,15.38888889,6.5,8.88888889,15,3,13,7,2,0,9,3,10,0,2,1,6,0,3,7,0,-1,0.2,0.333333333,-0.133333333
509,2,6,-4,w,9.92,7.444444444,2.475555556,10,2,8,4,2,0,9,6,11,3,2,0,1,-4,-3,1,0,0,0.2,0.666666667,-0.466666667
510,6,2,4,l,7.444444444,9.92,-2.475555556,10,2,8,4,2,0,9,6,11,3,2,0,1,-4,-3,1,0,0,0.2,0.666666667,-0.466666667
511,13,3,10,w,8.148148148,45.42857143,-37.28042328,5,1,5,2,1,0,17,6,11,7,2,0,-12,-5,-6,-5,-1,0,0.2,0.352941176,-0.152941176
512,3,13,-10,l,45.42857143,8.148148148,37.28042328,5,1,5,2,1,0,17,6,11,7,2,0,-12,-5,-6,-5,-1,0,0.2,0.352941176,-0.152941176
513,8,9,-1,l,9.476190476,8.724137931,0.752052545,18,4,12,12,2,0,23,10,10,7,0,0,-5,-6,2,5,2,0,0.222222222,0.434782609,-0.212560387
514,9,8,1,w,8.724137931,9.476190476,-0.752052545,18,4,12,12,2,0,23,10,10,7,0,0,-5,-6,2,5,2,0,0.222222222,0.434782609,-0.212560387
515,16,4,12,w,5.655172414,19.55555556,-13.90038315,15,7,15,5,2,0,10,2,9,6,0,0,5,5,6,-1,2,0,0.466666667,0.2,0.266666667
516,4,16,-12,l,19.55555556,5.655172414,13.90038315,15,7,15,5,2,0,10,2,9,6,0,0,5,5,6,-1,2,0,0.466666667,0.2,0.266666667
517,11,2,9,l,8.958333333,13.03571429,-4.077380957,17,1,11,9,4,0,9,3,11,8,3,0,8,-2,0,1,1,0,0.058823529,0.333333333,-0.274509804
518,2,11,-9,w,13.03571429,8.958333333,4.077380957,17,1,11,9,4,0,9,3,11,8,3,0,8,-2,0,1,1,0,0.058823529,0.333333333,-0.274509804
519,13,1,12,w,10.23076923,25.82352941,-15.59276018,20,7,5,6,0,0,3,0,7,1,1,0,17,7,-2,5,-1,0,0.35,0,0.35
520,1,13,-12,l,25.82352941,10.23076923,15.59276018,20,7,5,6,0,0,3,0,7,1,1,0,17,7,-2,5,-1,0,0.35,0,0.35
521,5,1,4,w,7.531914894,11,-3.468085106,17,7,14,3,1,0,5,3,14,5,2,0,12,4,0,-2,-1,0,0.411764706,0.6,-0.188235294
522,1,5,-4,l,11,7.531914894,3.468085106,17,7,14,3,1,0,5,3,14,5,2,0,12,4,0,-2,-1,0,0.411764706,0.6,-0.188235294
523,4,7,-3,l,5.92,7.483870968,-1.563870968,28,9,13,9,1,0,4,1,17,6,4,0,24,8,-4,3,-3,0,0.321428571,0.25,0.071428571
524,5,5,0,l,11.36363636,10.95238095,0.41125541,16,10,9,7,4,0,12,4,9,3,3,0,4,6,0,4,1,0,0.625,0.333333333,0.291666667
525,2,7,-5,d,15.66666667,7.333333333,8.333333337,14,3,3,12,0,0,8,2,6,2,2,0,6,1,-3,10,-2,0,0.214285714,0.25,-0.035714286
526,5,5,0,w,10.95238095,11.36363636,-0.41125541,16,10,9,7,4,0,12,4,9,3,3,0,4,6,0,4,1,0,0.625,0.333333333,0.291666667
527,8,2,6,w,6.87804878,9.65,-2.77195122,18,9,15,7,2,0,8,2,11,5,6,1,10,7,4,2,-4,-1,0.5,0.25,0.25
528,2,8,-6,l,9.65,6.87804878,2.77195122,18,9,15,7,2,0,8,2,11,5,6,1,10,7,4,2,-4,-1,0.5,0.25,0.25
529,7,2,5,d,7.333333333,15.66666667,-8.333333337,14,3,3,12,0,0,8,2,6,2,2,0,6,1,-3,10,-2,0,0.214285714,0.25,-0.035714286
530,7,4,3,w,7.483870968,5.92,1.563870968,28,9,13,9,1,0,4,1,17,6,4,0,24,8,-4,3,-3,0,0.321428571,0.25,0.071428571
531,3,12,-9,l,23.125,6.066666667,17.05833333,10,3,14,3,0,0,18,7,10,7,0,0,-8,-4,4,-4,0,0,0.3,0.388888889,-0.088888889
532,12,3,9,w,6.066666667,23.125,-17.05833333,10,3,14,3,0,0,18,7,10,7,0,0,-8,-4,4,-4,0,0,0.3,0.388888889,-0.088888889
533,8,3,5,w,9.181818182,9.184210526,-0.002392344,21,9,6,3,0,0,7,2,15,5,1,0,14,7,-9,-2,-1,0,0.428571429,0.285714286,0.142857143
534,5,3,2,l,9.739130435,10.57142857,-0.832298135,19,6,11,4,2,0,6,4,6,1,3,0,13,2,5,3,-1,0,0.315789474,0.666666667,-0.350877193
535,3,8,-5,l,9.184210526,9.181818182,0.002392344,21,9,6,3,0,0,7,2,15,5,1,0,14,7,-9,-2,-1,0,0.428571429,0.285714286,0.142857143
536,3,5,-2,w,10.57142857,9.739130435,0.832298135,19,6,11,4,2,0,6,4,6,1,3,0,13,2,5,3,-1,0,0.315789474,0.666666667,-0.350877193
537,5,1,4,w,13.6,10.77777778,2.82222222,9,4,12,6,0,0,17,5,12,3,4,0,-8,-1,0,3,-4,0,0.444444444,0.294117647,0.150326797
538,1,5,-4,l,10.77777778,13.6,-2.82222222,9,4,12,6,0,0,17,5,12,3,4,0,-8,-1,0,3,-4,0,0.444444444,0.294117647,0.150326797
539,14,3,11,w,3.361111111,33.7,-30.33888889,25,7,4,16,0,0,7,4,10,8,3,0,18,3,-6,8,-3,0,0.28,0.571428571,-0.291428571
540,3,14,-11,l,33.7,3.361111111,30.33888889,25,7,4,16,0,0,7,4,10,8,3,0,18,3,-6,8,-3,0,0.28,0.571428571,-0.291428571
541,10,5,5,l,7.52173913,8.178571429,-0.656832299,11,6,13,6,1,0,19,4,16,7,2,0,-8,2,-3,-1,-1,0,0.545454545,0.210526316,0.334928229
542,5,10,-5,w,8.178571429,7.52173913,0.656832299,11,6,13,6,1,0,19,4,16,7,2,0,-8,2,-3,-1,-1,0,0.545454545,0.210526316,0.334928229
543,8,5,3,l,6.173913043,17.05555556,-10.88164252,24,8,8,8,1,0,12,3,9,7,1,0,12,5,-1,1,0,0,0.333333333,0.25,0.083333333
544,5,8,-3,w,17.05555556,6.173913043,10.88164252,24,8,8,8,1,0,12,3,9,7,1,0,12,5,-1,1,0,0,0.333333333,0.25,0.083333333
545,4,14,-10,d,17.23076923,5.461538462,11.76923077,9,5,8,4,2,0,23,6,5,14,2,0,-14,-1,3,-10,0,0,0.555555556,0.260869565,0.294685991
546,1,5,-4,d,8.857142857,6.636363636,2.220779221,21,4,11,11,4,0,8,1,9,7,3,0,13,3,2,4,1,0,0.19047619,0.125,0.06547619
547,14,4,10,d,5.461538462,17.23076923,-11.76923077,9,5,8,4,2,0,23,6,5,14,2,0,-14,-1,3,-10,0,0,0.555555556,0.260869565,0.294685991
548,5,1,4,d,6.636363636,8.857142857,-2.220779221,21,4,11,11,4,0,8,1,9,7,3,0,13,3,2,4,1,0,0.19047619,0.125,0.06547619
549,7,5,2,l,4.545454545,14.57894737,-10.03349283,14,7,8,4,1,0,10,2,11,9,1,0,4,5,-3,-5,0,0,0.5,0.2,0.3
550,5,7,-2,w,14.57894737,4.545454545,10.03349283,14,7,8,4,1,0,10,2,11,9,1,0,4,5,-3,-5,0,0,0.5,0.2,0.3
551,12,6,6,l,11.54545455,33.18181818,-21.63636363,14,5,4,3,0,0,7,1,8,5,0,0,7,4,-4,-2,0,0,0.357142857,0.142857143,0.214285714
552,6,12,-6,w,33.18181818,11.54545455,21.63636363,14,5,4,3,0,0,7,1,8,5,0,0,7,4,-4,-2,0,0,0.357142857,0.142857143,0.214285714
553,5,7,-2,d,8.375,9.117647059,-0.742647059,16,5,11,13,3,0,14,5,11,8,4,0,2,0,0,5,-1,0,0.3125,0.357142857,-0.044642857
554,7,5,2,d,9.117647059,8.375,0.742647059,16,5,11,13,3,0,14,5,11,8,4,0,2,0,0,5,-1,0,0.3125,0.357142857,-0.044642857
555,5,2,3,l,7,12.70967742,-5.70967742,13,5,12,4,3,0,14,4,14,5,2,0,-1,1,-2,-1,1,0,0.384615385,0.285714286,0.098901099
556,2,5,-3,w,12.70967742,7,5.70967742,13,5,12,4,3,0,14,4,14,5,2,0,-1,1,-2,-1,1,0,0.384615385,0.285714286,0.098901099
557,3,9,-6,l,20.29411765,4.75,15.54411765,14,6,10,9,0,0,6,4,12,4,1,0,8,2,-2,5,-1,0,0.428571429,0.666666667,-0.238095238
558,9,3,6,w,4.75,20.29411765,-15.54411765,14,6,10,9,0,0,6,4,12,4,1,0,8,2,-2,5,-1,0,0.428571429,0.666666667,-0.238095238
559,7,10,-3,w,11.8,23.13333333,-11.33333333,9,2,11,6,1,0,14,6,9,7,2,0,-5,-4,2,-1,-1,0,0.222222222,0.428571429,-0.206349207
560,4,2,2,d,9.535714286,20,-10.46428571,11,1,4,2,1,0,7,1,7,0,3,0,4,0,-3,2,-2,0,0.090909091,0.142857143,-0.051948052
561,10,7,3,w,10.31818182,5.838709677,4.479472143,10,3,12,8,4,0,10,4,19,8,4,0,0,-1,-7,0,0,0,0.3,0.4,-0.1
562,4,4,0,w,5,12.52380952,-7.52380952,6,3,14,5,0,1,14,7,15,8,3,0,-8,-4,-1,-3,-3,1,0.5,0.5,0
563,3,10,-7,l,8.0625,9.941176471,-1.878676471,10,4,12,10,0,0,12,5,8,5,0,0,-2,-1,4,5,0,0,0.4,0.416666667,-0.016666667
564,10,3,7,w,9.941176471,8.0625,1.878676471,10,4,12,10,0,0,12,5,8,5,0,0,-2,-1,4,5,0,0,0.4,0.416666667,-0.016666667
565,4,4,0,l,12.52380952,5,7.52380952,6,3,14,5,0,1,14,7,15,8,3,0,-8,-4,-1,-3,-3,1,0.5,0.5,0
566,7,10,-3,l,5.838709677,10.31818182,-4.479472143,10,3,12,8,4,0,10,4,19,8,4,0,0,-1,-7,0,0,0,0.3,0.4,-0.1
567,10,7,3,l,23.13333333,11.8,11.33333333,9,2,11,6,1,0,14,6,9,7,2,0,-5,-4,2,-1,-1,0,0.222222222,0.428571429,-0.206349207
568,2,4,-2,d,20,9.535714286,10.46428571,11,1,4,2,1,0,7,1,7,0,3,0,4,0,-3,2,-2,0,0.090909091,0.142857143,-0.051948052
569,6,4,2,d,7.580645161,12.52941176,-4.948766599,21,8,16,3,5,0,13,2,11,5,4,0,8,6,5,-2,1,0,0.380952381,0.153846154,0.227106227
570,4,6,-2,d,12.52941176,7.580645161,4.948766599,21,8,16,3,5,0,13,2,11,5,4,0,8,6,5,-2,1,0,0.380952381,0.153846154,0.227106227
571,9,3,6,w,12.71428571,19.08695652,-6.37267081,17,11,8,6,1,0,3,1,10,1,2,0,14,10,-2,5,-1,0,0.647058824,0.333333333,0.313725491
572,3,9,-6,l,19.08695652,12.71428571,6.37267081,17,11,8,6,1,0,3,1,10,1,2,0,14,10,-2,5,-1,0,0.647058824,0.333333333,0.313725491
573,2,3,-1,l,6.041666667,14.70967742,-8.668010753,12,6,11,2,2,0,7,2,9,11,4,0,5,4,2,-9,-2,0,0.5,0.285714286,0.214285714
574,3,2,1,w,14.70967742,6.041666667,8.668010753,12,6,11,2,2,0,7,2,9,11,4,0,5,4,2,-9,-2,0,0.5,0.285714286,0.214285714
575,2,8,-6,l,13.2173913,5.379310345,7.838080955,15,7,15,9,2,0,4,1,12,0,1,0,11,6,3,9,1,0,0.466666667,0.25,0.216666667
576,8,2,6,w,5.379310345,13.2173913,-7.838080955,15,7,15,9,2,0,4,1,12,0,1,0,11,6,3,9,1,0,0.466666667,0.25,0.216666667